Protamine-Zinc-Insulin	NN	Protamine-Zinc-Insulin
Rosenburg	NN	Rosenburg
Squibb	VVFIN	Squibb
Galizien	NE	Galizien
Halensee	NE	Halensee
12tägiger	ADJA	12tägiger
26jährigen	ADJA	26jährig
35jährigem	ADJA	35jährig
3klassigen	ADJA	3klassigen
4-händige	NN	4-händige
5klassig	ADJD	5klassig
8tägigen	ADJA	8tägigen
8uhr	NN	8uhr
A-moll	NN	A-moll
Aaß	NN	Aaß
Abbildgn	NN	Abbildgn
Abendgesellschaft	NN	Abendgesellschaft
Abendgesellschaften	NN	Abendgesellschaft
Abertausende	ADJA	abertausend
Abgesang-Stollen	ADJA	Abgesang-Stollen
Abh	ADJA	Abh
Abhängigkeitsbeziehung	NN	Abhängigkeitsbeziehung
Abiturientenkurses	NN	Abiturientenkurses
Abrichtungszeit	NN	Abrichtungszeit
Abs	ADJA	Abs
Absatzmöglichkeit	NN	Absatzmöglichkeit
Abschieds-Abend	NN	Abschieds-Abend
Absolvierung	NN	Absolvierung
Abstr	NE	Abstr
Achtstundentag	NN	Achtstundentag
Achtzigerjahre	NN	Achtzigerjahr
Addressee	NE	Addressee
Addressee's	NE	Addressee's
Adressbuch	NN	Adressbuch
Adressenangaben	NN	Adressenangaben
Adveniat	NN	Adveniat
Aegyd	NE	Aegyd
Aegyptern	NN	Aegyptern
Aenderung	NN	Aenderung
Aeusserung	NN	Aeusserung
Aigen	NE	Aigen
Aj	NE	Aj
Aktiengesellschaft	NN	Aktiengesellschaft
Akz	NE	Akz
Albergo	NN	Albergo
Alfred	NE	Alfred
Alleinseins	NN	Alleinsein
Alois	NE	Alois
Alpdruck	NN	Alpdruck
Alseggerstr	NE	Alseggerstr
Alszauberkonzert	NN	Alszauberkonzert
Altartuchs	NN	Altartuchs
Altersgrenze	NN	Altersgrenze
Amtskummer	NN	Amtskummer
Anastrophe	NE	Anastrophe
Anbei	ADV	anbei
Anfangsschwierigkeiten	NN	Anfangsschwierigkeit
Anhaltspunkte	NN	Anhaltspunkt
Anna-Lise	NE	Anna-Lise
Anny	NE	Anny
Anpassungsvermögen	NN	Anpassungsvermögen
Ansichtsbild	NN	Ansichtsbild
Anstoss	NN	Anstoss
Antheil	NN	Antheil
Antologie	NN	Antologie
Antwerpens	NE	Antwerpen
Antwortbrief	NN	Antwortbrief
Antwortformular	NN	Antwortformular
Antwortschreiben	NN	Antwortschreiben
Antypathie	NN	Antypathie
Apr	NN	Apr
Arbeiterzeitung	NN	Arbeiterzeitung
Arbeitsfreudigkeit	NN	Arbeitsfreudigkeit
Arbeitslosenunterstützung	NN	Arbeitslosenunterstützung
Argentinierstr	NE	Argentinierstr
Argentinierstraße	NN	Argentinierstraße
Armeekommando	NN	Armeekommando
Arschloch	NN	Arschloch
Artillerie-Auto-Detachement	NN	Artillerie-Auto-Detachement
Artillerie-Autodetachement	NN	Artillerie-Autodetachement
Artillerie-Werkstätte	NN	Artillerie-Werkstätte
Artillerieaufklärer	NN	Artillerieaufklärer
Assentjahr	NN	Assentjahr
Assyrern	NN	Assyrer
Athempause	NN	Athempause
Auen	NN	Aue
Auffasssung	NN	Auffasssung
Aufl	NN	Aufl
Aufnahmeprüfung	NN	Aufnahmeprüfung
Ausfuhrverbot	NN	Ausfuhrverbot
Ausnahmszustand	NN	Ausnahmszustand
Ausschrotung	NN	Ausschrotung
Auto-Detachement	NN	Auto-Detachement
Autoreparaturwerkstätte	NN	Autoreparaturwerkstätte
Axur	NE	Axur
B1	NE	B1
BPhDI	NE	BPhDI
Babylon	NE	Babylon
Babyloniern	NN	Babyloniern
Bachschen	NN	Bachschen
Backmassregeln	NN	Backmassregeln
Badeanstalt	NN	Badeanstalt
Barclay	NE	Barclay
Barmherzigen	ADJA	barmherzig
Barton	NN	Barton
Bassia	NE	Bassia
Batg1	NE	Batg1
Batt	NN	Batt
Bauernkriegen	NN	Bauernkrieg
Baumayer	NE	Baumayer
Baumeister	NN	Baumeister
Baumstamm	NN	Baumstamm
Beantwortenswertes	ADJA	Beantwortenswertes
Bedauren	NN	Bedauren
Bedeutungsfestsetzung	NN	Bedeutungsfestsetzung
Beeth	NE	Beeth
Begleitbrief	NN	Begleitbrief
Bekanntgabe	NN	Bekanntgabe
Belsazer	ADJA	Belsazer
Benediktinerstifte	NN	Benediktinerstifte
Beneschau	NN	Beneschau
Bereitwilligkeit	NN	Bereitwilligkeit
Berggelände	NN	Berggelände
Bergwerk	NN	Bergwerk
Berkeleystreet	NE	Berkeleystreet
Berlin-Halensee	NN	Berlin-Halensee
Berlin-Kurfürstendamm	NN	Berlin-Kurfürstendamm
Berlioz	NE	Berlioz
Bernscherer	NN	Bernscherer
Bertl	NE	Bertl
Berufsphilosophen	NN	Berufsphilosophen
Berufswahl	NN	Berufswahl
Beruhigungsmittel	NN	Beruhigungsmittel
Besuchszeiten	NN	Besuchszeit
Betr	NE	Betr
Bettwäsche	NN	Bettwäsche
Betty	NE	Betty
Bevan	NN	Bevan
Bevans	NN	Bevans
Bewußtseinstatsachen	ADJA	Bewußtseinstatsachen
Beynum	NN	Beynum
Bezirksgericht	NN	Bezirksgericht
Bilderbücher	NN	Bilderbuch
Bildhauerton	NN	Bildhauerton
Birger	NE	Birger
Biscuitkugelhupf	NN	Biscuitkugelhupf
Bittbrief	NN	Bittbrief
Blattkrone	NN	Blattkrone
Bln	ADJA	Bln
Bln-Halensee	NN	Bln-Halensee
Blochberger	NE	Blochberger
Blumenstock	NN	Blumenstock
Blutarmut	NN	Blutarmut
Blutbefund	NN	Blutbefund
Blutuntersuchung	NN	Blutuntersuchung
Blutvergiftung	NN	Blutvergiftung
Bläserklang	NN	Bläserklang
Bläserquintett	NN	Bläserquintett
Boldrino	NE	Boldrino
Bong'schen	NN	Bong'schen
Bongsche	NN	Bongsche
Borromäus	NE	Borromäus
Boswell	NE	Boswell
Bradley	NE	Bradley
Brahms'schen	ADJA	Brahms'schen
Brahmsplatz	NN	Brahmsplatz
Brandbrief	NN	Brandbrief
Braumüller	NN	Braumüller
Breitenseeer-Anstalt	NN	Breitenseeer-Anstalt
Breitenseerstraße	NN	Breitenseerstraße
Brenner-Jahrbuch	NN	Brenner-Jahrbuch
Brenner-Unternehmen	NN	Brenner-Unternehmen
Brenner-Verlag	NN	Brenner-Verlag
Bretzeln	ADJA	Bretzeln
Briefanworten	NN	Briefanworten
Briefbelege	NN	Briefbelege
Briefentwurf	NN	Briefentwurf
Briefpapier	NN	Briefpapier
Briefschreiben	NN	Briefschreiben
Briefwage	NN	Briefwage
Briefwechsel	NN	Briefwechsel
Brixen	ADJA	Brixen
Brochure	NN	Brochure
Brockhaus	NN	Brockhaus
Brod	NE	Brod
Brodesser	NE	Brodesser
Brodmarken	NE	Brodmarken
Brodware	NN	Brodware
Bronchialkatarrh	NN	Bronchialkatarrh
Brother-in-law	NN	Brother-in-law
Brotkarte	NN	Brotkarte
Bruderzwist	NN	Bruderzwist
Brummbär	NN	Brummbär
Bruno	NE	Bruno
Brunshaupten	NE	Brunshaupten
Brunswick	NE	Brunswick
Brutstätte	NN	Brutstätte
Brünn	ADJD	Brünn
Bt	ADJA	Bt
Btt	NN	Btt
Buchdruck	NN	Buchdruck
Buchhandel	NN	Buchhandel
Buchhandlung	NN	Buchhandlung
Buchhandlungen	NN	Buchhandlung
Buchverlag	NN	Buchverlag
Buchverlags	NN	Buchverlag
Bulbüls	NN	Bulbüls
Burggarten	NN	Burggarten
Bursar	NN	Bursar
Bury	NN	Bury
Buschbriefe	NN	Buschbriefe
Butter-Margarine	NN	Butter-Margarine
Butternot	NN	Butternot
Bädeckern	NN	Bädeckern
Bärens	NN	Bärens
Bücherpakete	NN	Bücherpaket
Bücherschrank	NN	Bücherschrank
Bürgerkunde	NN	Bürgerkunde
Bürgerkundl	NN	Bürgerkundl
Bürgersch	NN	Bürgersch
Bürgerschul-Weltgeschichten	NN	Bürgerschul-Weltgeschichten
Bürgerschule	NN	Bürgerschule
Bürgerschulen	NN	Bürgerschulen
Caffeehaus	NN	Caffeehaus
Caker	NN	Caker
Cakes	NE	Cakes
Cakesbrief	NN	Cakesbrief
Cakespakete	NN	Cakespakete
Cakessendung	NN	Cakessendung
Calais	NN	Calais
Calasanz	NN	Calasanz
Calasanzverein	NN	Calasanzverein
Calif	NE	Calif
Carl	NE	Carl
Carnap'schen	NN	Carnap'schen
Carnaps	NN	Carnaps
Carnapschen	NN	Carnapschen
Caserta	NE	Caserta
Catarrh	NE	Catarrh
Cato	NE	Cato
Chargenschule	NN	Chargenschule
Charlatan	NE	Charlatan
Chocolade	NN	Chocolade
Chokolade	NN	Chokolade
Christbaum	NN	Christbaum
Christo	NE	Christo
Clarinettenquintett	NE	Clarinettenquintett
Co	NN	Co
College-Rechnung	NN	College-Rechnung
Collegen	NN	Collegen
Comité	NN	Comité
Commentar	NN	Commentar
Communion	NN	Communion
Compagnon	NN	Compagnon
Compagnons	NN	Compagnons
Conditorei	NN	Conditorei
Condolencbrief	NN	Condolencbrief
Conserven	NN	Conserven
Conspiration	NN	Conspiration
Continent	NN	Continent
Conversations	NN	Conversations
Conzert	NN	Conzert
Conzertstück	NN	Conzertstück
Cornet	NE	Cornet
Correspondenz	NE	Correspondenz
Croix	VVFIN	Croix
Cunard	NE	Cunard
Curatell	NE	Curatell
Curazza	VVFIN	Curazza
Custozza	NE	Custozza
Cw	NE	Cw
Czar	NE	Czar
Czartoryski'sche	ADJA	Czartoryski'sche
Dalago	NN	Dalago
Dalagos	NE	Dalagos
Dallagos	NE	Dallagos
Dalmatien	NE	Dalmatien
Dank-Telegramm	NN	Dank-Telegramm
Dankbriefen	ADJA	Dankbriefen
Dankesschuld	NN	Dankesschuld
Dankzeilen	NN	Dankzeilen
Dank	APPR	dank
’	ADJA	’
Darminfektion	NN	Darminfektion
Darmkatarh	NN	Darmkatarh
Darmkatarrh	NN	Darmkatarrh
Darmleiden	NN	Darmleiden
Darmzustand	NN	Darmzustand
Daseinsart	NN	Daseinsart
Dasy	NE	Dasy
Davidsbündlern	NN	Davidsbündlern
Davos	NE	Davos
Deckenkappen	NN	Deckenkappen
Dehmel	NN	Dehmel
Deinerseits	NN	Deinerseits
Demnächst	ADV	demnächst
Demonst	VVFIN	Demonst
Deneke	NE	Deneke
Denekes	NE	Denekes
Denkfaulen	ADJA	denkfaul
Denkmalsetzen	NN	Denkmalsetzen
Deutsch-Mark	NE	Deutsch-Mark
Deutschböhme	ADJA	Deutschböhme
Deutschstunde	NN	Deutschstunde
Dezimal-Numerierung	NN	Dezimal-Numerierung
Dezimalnummern	NN	Dezimalnummern
Dichterwort	NN	Dichterwort
Dictat	VVFIN	Dictat
Dienst-Anschrift	NN	Dienst-Anschrift
Diensteifers	NN	Diensteifers
Dienstzweig	NN	Dienstzweig
Dilema	NN	Dilema
Dirs	NE	Dirs
Disciplin	NN	Disciplin
Docktor	NN	Docktor
Doktorrechnungen	NN	Doktorrechnungen
Doppel-s	NN	Doppel-s
Dormitat	NN	Dormitat
Dornbach	NE	Dornbach
Dostojewski-Aufsatz	NN	Dostojewski-Aufsatz
Dreibundes	NN	Dreibund
Drobilsche	NE	Drobilsche
Druckfehler	NN	Druckfehler
Druckmanuscript	NN	Druckmanuscript
Drüsenschwellung	NN	Drüsenschwellung
Dummerweise	ADJA	Dummerweise
Durchblaettern	NN	Durchblaettern
Durchbruch	NN	Durchbruch
Dzwiecki	NE	Dzwiecki
Däubler	ADJA	Däubler
Ebenhausen	NN	Ebenhausen
Eberhard	NE	Eberhard
Eberhard's	NE	Eberhard's
Edelmut	NN	Edelmut
Edward's	VVFIN	Edward's
Edwin	NE	Edwin
Ehrengabe	NN	Ehrengabe
Ehrenmann	NN	Ehrenmann
Ehrenstein	NE	Ehrenstein
Ehrensteinen	NN	Ehrensteinen
Eigenart	NN	Eigenart
Eigenlob	NN	Eigenlob
Einbändige	NN	Einbändige
Einj	NE	Einj
Einjährigen-Chargen	ADJA	Einjährigen-Chargen
Einreisebewilligung	NN	Einreisebewilligung
Einrichtungs-Aufträge	NN	Einrichtungs-Aufträge
Einrückungstermine	NN	Einrückungstermine
Einvernehmen	NN	Einvernehmen
Eire	NN	Eire
Eisacktals	NN	Eisacktals
Eisenhut	NN	Eisenhut
Eiskasten	NN	Eiskasten
Eislaufen	NN	Eislaufen
Elektrizitätswerk	NN	Elektrizitätswerk
Elementarlehrer	NN	Elementarlehrer
Elisabeth	NE	Elisabeth
Elis	NE	Elis
’	NN	’
Elsa	NE	Elsa
Elt	NN	Elt
Elternhauses	NN	Elternhaus
Embalage	NN	Embalage
Embrio	NN	Embrio
Empfehlungsschreiben	NN	Empfehlungsschreiben
Empfiel	VVFIN	Empfiel
Endeffekt	NN	Endeffekt
Engl	NE	Engl
Enquirer	ADJA	Enquirer
Entruestung	NN	Entruestung
Erbswurst	NN	Erbswurst
Erfurt	NE	Erfurt
Ergehn	NN	Ergehn
Erholungsurlaubes	NN	Erholungsurlaubes
Erinnerungswert	NN	Erinnerungswert
Ernestine	NE	Ernestine
Ernährungsverhältnissen	NN	Ernährungsverhältnissen
Ers	ADJA	Ers
Ersatz-Komp	NN	Ersatz-Komp
Erudition	NN	Erudition
Erziehungsheim	NN	Erziehungsheim
Erzscharlatan	NN	Erzscharlatan
Escapaden	VVFIN	Escapaden
Escompte-Gesellschaft	NN	Escompte-Gesellschaft
Esslöffel	NN	Esslöffel
Etzel	NE	Etzel
Eugen	NE	Eugen
Ewigkeitsgedanken	NN	Ewigkeitsgedanken
Exemplares	NN	Exemplar
Existenzverhältnisse	NN	Existenzverhältnis
Expr	NN	Expr
Express-Brief	NN	Express-Brief
Expresskarte	NN	Expresskarte
Expreßpost	NN	Expreßpost
Eßwaren	NN	Eßware
Faber	NE	Faber
Fagottsolo	NN	Fagottsolo
Familienkreis	NN	Familienkreis
Familienunähnlichkeit	NN	Familienunähnlichkeit
Fanfarenstöße	NN	Fanfarenstoß
Fania	NE	Fania
Fassungsvermögens	NN	Fassungsvermögen
Faustvorträgen	NN	Faustvorträgen
Febr	NN	Febr
Feiertag	NN	Feiertag
Feiertagen	NN	Feiertag
Feigl	NE	Feigl
Feldhaubitzen	NN	Feldhaubitze
Feldhaubitzen-Regiment	NN	Feldhaubitzen-Regiment
Feldhaubitzenregiment	NN	Feldhaubitzenregiment
Feldheer	NN	Feldheer
Feldkanonen	NN	Feldkanonen
Feldkanonenregiment	NN	Feldkanonenregiment
Feldkanonenzug	NN	Feldkanonenzug
Feldkirch	NE	Feldkirch
Feldmarschall-Leutnant	NN	Feldmarschall-Leutnant
Feldp	NN	Feldp
Feldpakete	NN	Feldpakete
Feldpost	NN	Feldpost
Feldpost-Karten	NN	Feldpost-Karten
Feldpostamt	NN	Feldpostamt
Feldpostkarte	NN	Feldpostkarte
Feldpostkarten	NN	Feldpostkarte
Feldpostkorrespondenzkarte	NN	Feldpostkorrespondenzkarte
Feldpostpaket	NN	Feldpostpaket
Feldposttelegramm	NN	Feldposttelegramm
Feldsoldaten	NN	Feldsoldaten
Feldspital	NN	Feldspital
Feldzug	NN	Feldzug
Felix	NE	Felix
Festkreise	NN	Festkreise
Festschrift	NN	Festschrift
Festspiel	NN	Festspiel
Fettflecke	NN	Fettfleck
Fettkur	NN	Fettkur
Fettpatzen	ADJA	Fettpatzen
Feueranzünden	NN	Feueranzünden
Feuerreiter	NN	Feuerreiter
Feuerwehrball	NN	Feuerwehrball
Feuerwerksstücke	NN	Feuerwerksstücke
Fhrch	NE	Fhrch
Fichteg	NN	Fichteg
Fillunger	NN	Fillunger
Filu	NE	Filu
Filu's	NE	Filu's
Flammenschrift	NN	Flammenschrift
Flecktyphus-Epidemie	NN	Flecktyphus-Epidemie
Florian	NE	Florian
Flugdrachen	NN	Flugdrachen
Flugpost	NN	Flugpost
Fluth	NE	Fluth
Flüßigkeit	NN	Flüßigkeit
Folgeerscheinung	NN	Folgeerscheinung
Formsache	NN	Formsache
Forschungsgebiet	NN	Forschungsgebiet
Forschungsgruppe	NN	Forschungsgruppe
Forstweg	NN	Forstweg
Fp	NE	Fp
Fr's	NE	Fr's
Fragesteller	NN	Fragesteller
Fraun	NN	Fraun
Freiluftaufführung	NN	Freiluftaufführung
Freispruch	NN	Freispruch
Freiw	NN	Freiw
Freiwilliger	ADJA	freiwillig
Fremdenzimmer	NN	Fremdenzimmer
Freudenbotschaft	NN	Freudenbotschaft
Freudisches	ADJA	Freudisches
Freundeskreis	NN	Freundeskreis
Freundespflicht	ADJA	Freundespflicht
Freundschaftsdienst	NN	Freundschaftsdienst
Freundschaftsverhältnis	NN	Freundschaftsverhältnis
Friedensschluss	NN	Friedensschluss
Friedensschluß	NN	Friedensschluss
Friedhof	NN	Friedhof
Friedrich	NE	Friedrich
Frl	NE	Frl
Frostlake	NN	Frostlake
Frottierhandtuch	NN	Frottierhandtuch
Fuchsel	NN	Fuchsel
Fußnote	NN	Fußnote
Fußtour	NN	Fußtour
Fürstenallee	NN	Fürstenallee
G'schaftelhuberei	NN	G'schaftelhuberei
Gaisirs	NN	Gaisirs
Galden	NN	Galden
Galizien	NE	Galizien
Galiziens	NE	Galiziens
Gallenanfall	NN	Gallenanfall
Gallensteinen	NN	Gallenstein
Gartenarbeit	NN	Gartenarbeit
Gastfreunde	NN	Gastfreunde
Gastfreundschaft	NN	Gastfreundschaft
Gasthof	NN	Gasthof
Gastmahl	NN	Gastmahl
Gastmäler	NN	Gastmäler
Gebirgsart	NN	Gebirgsart
Gebirgsartillerie	NN	Gebirgsartillerie
Gebirgsartillerieregiments	NN	Gebirgsartillerieregiments
Geburtsstunde	NN	Geburtsstunde
Geburtstage	NN	Geburtstag
Geburtstagsgeschenk	NN	Geburtstagsgeschenk
Gedankenabfolge	NN	Gedankenabfolge
Gedankenaustausch	NN	Gedankenaustausch
Gedankenmaterial	NN	Gedankenmaterial
Gedichtbuch	NN	Gedichtbuch
Gegebensein	NN	Gegebensein
Gegenwärtigsein	NN	Gegenwärtigsein
Geheimrat	NN	Geheimrat
Geistreichtum	NN	Geistreichtum
Geißmayr	NE	Geißmayr
Gelddingen	NN	Geldding
Geldmangels	NN	Geldmangel
Geldumwechslerei	NN	Geldumwechslerei
Gelenkentzündung	NN	Gelenkentzündung
Gellert	NE	Gellert
Gemäldesammlung	NN	Gemäldesammlung
Gemütsdepressionen	NN	Gemütsdepressionen
Gemütsmenschen	NN	Gemütsmensch
Genrescene	NN	Genrescene
Genève	NN	Genève
Gerichtspsychiater	NN	Gerichtspsychiater
Geringschätzung	NN	Geringschätzung
Germkugelh	ADJA	Germkugelh
Germkugelhupfs	NN	Germkugelhupfs
Gesamtaufstellung	NN	Gesamtaufstellung
Gesandschaft	NN	Gesandschaft
Gesangskünstler	NN	Gesangskünstler
Gesangsstück	NN	Gesangsstück
Gesangsverein	NN	Gesangsverein
Gesch	NN	Gesch
Geschichtsbuches	NN	Geschichtsbuch
Geschichtslesebuch	NN	Geschichtslesebuch
Geschwefel	NN	Geschwefel
Geschäftsgeist	NN	Geschäftsgeist
Geschäftsinteresse	NN	Geschäftsinteresse
Geschäftsstil	NN	Geschäftsstil
Gesprächsstoff	NN	Gesprächsstoff
Gesundheitsrücksichten	ADJA	Gesundheitsrücksichten
Gesundheitszustand	NN	Gesundheitszustand
Gesundwerden	NN	Gesundwerden
Gewährsleute	NN	Gewährsleute
Geyer	NE	Geyer
Gieshamgut	NN	Gieshamgut
Gindely-John	NE	Gindely-John
Glasröhren	NN	Glasröhre
Glassplitter	NN	Glassplitter
Gleichgewichtes	NN	Gleichgewicht
Glossop	NN	Glossop
Glückwünsche	NN	Glückwunsch
Gmunden	NN	Gmunden
Gnadenakt	NN	Gnadenakt
Gnigl	NE	Gnigl
Goethedenkmal	NN	Goethedenkmal
Gottbefohlen	ADJA	Gottbefohlen
Gottesgeschenk	NN	Gottesgeschenk
Gottgefühl	NN	Gottgefühl
Gottwill	NE	Gottwill
Goulasch	NN	Goulasch
Grammophonaufnahme	NN	Grammophonaufnahme
Gramophon	NN	Gramophon
Gramophonplatten	NN	Gramophonplatten
Grashalmen	NN	Grashalm
Gratulationsbrief	NN	Gratulationsbrief
Graz	NE	Graz
Gretls	NE	Gretls
Grety	NE	Grety
Grimm-Märchen	NN	Grimm-Märchen
Grimmburg	NE	Grimmburg
Grinzing	NE	Grinzing
Grodzinsky	NE	Grodzinsky
Groller	ADJA	Groller
Großmama	NN	Großmama
Großmut	NN	Großmut
Großmächte	NN	Großmacht
Gruber	NE	Gruber
Gruberls	NN	Gruberls
Gruess	NN	Gruess
Grundfrage	NN	Grundfrage
Grundproblem	NN	Grundproblem
Gruss	NN	Gruß
Grusse	NN	Gruß
Grußen	NN	Grußen
Grußkarte	NN	Grußkarte
Grzegorzki	NE	Grzegorzki
Gröger	NE	Gröger
Grüsse	NN	Gruß
Grüssen	NN	Gruß|Grüßen
Gugelhupf	NN	Gugelhupf
Gullivers	NE	Gullivers
Gutruf	NN	Gutruf
Gärtnergehilfe	NN	Gärtnergehilfe
Göschenheft	NE	Göschenheft
Gütergemeinschaft	NN	Gütergemeinschaft
Haase-Schulbücher-Verlag	NN	Haase-Schulbücher-Verlag
Habilitationsarbeit	NN	Habilitationsarbeit
Habsb	ADJA	Habsb
Haecker	NN	Haecker
Haidendenkmal	NN	Haidendenkmal
Halbjahr	NN	Halbjahr
Halbverdaute	ADJA	halbverdaut
Halensee	NN	Halensee
Hallwang	NN	Hallwang
Halunk	NN	Halunk
Handelsakademie	NN	Handelsakademie
Handelsdampfer	NN	Handelsdampfer
Handschriftlich	ADJD	handschriftlich
Handtücher	NN	Handtuch
Hanna	NE	Hanna
Hannibals	NE	Hannibals
Hansi	NE	Hansi
Hassbach	NE	Haßbach
Hauptarten	NN	Hauptarten
Hauptmanns	NE	Hauptmann
Hauptschuld	NN	Hauptschuld
Hauptwerk	NN	Hauptwerk
Hauptzollamt	NN	Hauptzollamt
Hauptzweck	NN	Hauptzweck
Hausgebrauch	NN	Hausgebrauch
Hausherrn	NN	Hausherr
Hausmeister	NN	Hausmeister
Hausorden	NN	Hausorden
Hausschatz	NN	Hausschatz
Havard	NE	Havard
Hebbel	ADJA	Hebbel
Hebbelschen	ADJA	Hebbelschen
Hebel's	NN	Hebel's
Hebelausgabe	NN	Hebelausgabe
Hedwig	NE	Hedwig
Heferln	NN	Heferln
Heilanstalt	NN	Heilanstalt
Heimfahrt	NN	Heimfahrt
Heimreise	NN	Heimreise
Heimweg	NN	Heimweg
Heinrichsthal	NE	Heinrichsthal
Heldenmute	ADJA	Heldenmute
Helenchen	NN	Helenchen
Helenes	NE	Helene
Henryk	NE	Henryk
Heringssalat	NN	Heringssalat
Herkners	NE	Herkners
Hermanns	NE	Hermann
Hermine	NE	Hermine
Hernals	NN	Hernals
Hernalser	NE	Hernalser
Herrenmenage	NN	Herrenmenage
Herstellungskosten	NN	Herstellungskosten
Hertha	NE	Hertha
Herzensfreude	NN	Herzensfreude
Herzenssache	NN	Herzenssache
Herzensschätzen	NN	Herzensschätzen
Herzl	NE	Herzl
Herzlichst	VVFIN	Herzlichst
Herzlähmung	NN	Herzlähmung
Hietzing	NE	Hietzing
Himbeerbriefe	NN	Himbeerbriefe
Hingegen	ADV	hingegen
Hinscheiden	NN	Hinscheiden
Hiobspost	NN	Hiobspost
Hirschbraten	NN	Hirschbraten
Hochachtung	NN	Hochachtung
Hochachtungsvoll	ADJD	Hochachtungsvoll
Hochgeehrte	ADJA	hochgeehrt
Hochmut	NN	Hochmut
Hochreut	ADJA	Hochreut
Hochschule	NN	Hochschule
Hochschulkurs	NN	Hochschulkurs
Hochverehrte	ADJA	hochverehrt
Hockegasse	NN	Hockegasse
Hoek	NE	Hoek
Hofbibliotek	NE	Hofbibliotek
Hofbibliothek	NN	Hofbibliothek
Hoffmann	NE	Hoffmann
Hoffnungsstrahl	NN	Hoffnungsstrahl
Hofmeisterposten	NN	Hofmeisterposten
Hofmuseen	NN	Hofmuseen
Hohenberg	NE	Hohenberg
Holland	NE	Holland
Holzmangel	NN	Holzmangel
Holzvorräte	NN	Holzvorrat
Homer	NN	Homer
Hotel-Zimmer	NE	Hotel-Zimmer
Hotel-restaurant	NN	Hotel-restaurant
Hugo	NE	Hugo
Hume-Studien	NN	Hume-Studien
Hundedreck	NN	Hundedreck
Husaren-Rgt	NN	Husaren-Rgt
Hxszhrzn	NE	Hxszhrzn
Händel-Variationen	NN	Händel-Variation
Hänsels	NN	Hänsels
Hôtel	NN	Hôtel
Hôtels	NN	Hôtels
Höhlmann	NN	Höhlmann
Hölder	NN	Hölder
Hölder-Pichler-Tempsky	NE	Hölder-Pichler-Tempsky
Höllenflammen	NN	Höllenflammen
Höllenkomödie	NN	Höllenkomödie
Hütteldorf	NN	Hütteldorf
IIIten	NN	IIIten
Ibsens	NN	Ibsens
Ickenham	NE	Ickenham
Idealgestalt	NN	Idealgestalt
Identitätsgesetze	NN	Identitätsgesetze
Ietzter	ADJA	Ietzter
Ihrethalben	NN	Ihrethalben
Ihretwillen	NN	Ihretwillen
Impfschein	NN	Impfschein
Inanitas	NE	Inanitas
Individualbrief	NN	Individualbrief
Infection	NN	Infection
Influenzapastillen	NN	Influenzapastillen
Influenzawetter	NN	Influenzawetter
Ing	ADJA	Ing
Ingenieurwesen	NN	Ingenieurwesen
Ingerenz	NE	Ingerenz
Ingénieur	NE	Ingénieur
Inhaltsangabe	NN	Inhaltsangabe
Inlibris	NN	Inlibris
Innigst	NE	Innigst
Innsbruck	NE	Innsbruck
Innsbruck-Mühlau	ADJD	Innsbruck-Mühlau
Innsbrucker	NN	Innsbrucker
Insel-Verlags	NN	Insel-Verlags
Inselstraße	NN	Inselstraße
Instrumentalmusik	NN	Instrumentalmusik
Intelex-Ausgabe	NN	Intelex-Ausgabe
Intourist	NN	Intourist
Intrigue	NE	Intrigue
Jahoda	NE	Jahoda
Jahrbücher	NN	Jahrbuch
Jahresanfang	NN	Jahresanfang
Jahreswechsel	NN	Jahreswechsel
Jahr	NN	Jahr
Jampot	NN	Jampot
Janko	NE	Janko
Janowska	NE	Janowska
Januartagen	NN	Januartag
Jehovah	NE	Jehovah
Jehovahs	NE	Jehovahs
Jena	NE	Jena
Ji	NE	Ji
Jochen's	VVFIN	Jochen's
Johann	NE	Johann
Johannes	NE	Johannes
Johannisbad	NN	Johannisbad
Jolles-Berlin-Halensee	NN	Jolles-Berlin-Halensee
Jordan	NE	Jordan
Jos	NE	Jos
Josef	NE	Josef
Jourdain	NN	Jourdain
Jubeltag	NN	Jubeltag
Jugendgericht	NN	Jugendgericht
Jugoslavien	NE	Jugoslavien
Jägerschen	NN	Jägerschen
Kaffeetabletten	NN	Kaffeetabletten
Kaiserjäger	NN	Kaiserjäger
Kaiserjäger-Regiment	NN	Kaiserjäger-Regiment
Kalligr	NE	Kalligr
Kameels	NN	Kameels
Kammerer	NN	Kammerer
Kammerers	NN	Kammerers
Kanonen-Batterie	NN	Kanonen-Batterie
Kanonenb	NN	Kanonenb
Kanonenbatterie	NN	Kanonenbatterie
Kant-Vorträge	NN	Kant-Vorträge
Kanzleitätigkeit	NN	Kanzleitätigkeit
Karajan	NE	Karajan
Karamasoff	NE	Karamasoff
Karamasow	NE	Karamasow
Karban	NE	Karban
Karla	NE	Karla
Karlskirche	NE	Karlskirche
Karpathen	NE	Karpathen
Karpathenoffensive	NN	Karpathenoffensive
Karsamstag	NN	Karsamstag
Kartengruss	NN	Kartengruß
Kartengruß	NN	Kartengruß
Kartenschreiben	NN	Kartenschreiben
Kata	NE	Kata
Katarh	NN	Katarh
Kauders	NN	Kauders
Keinesfalls	ADV	keinesfalls
Kinderbücherei	NN	Kinderbücherei
Kinderfreund	NE	Kinderfreund
Kindergruß	NN	Kindergruß
Kindeskindern	NN	Kindeskind
King's	VVFIN	King's
Kirchberg	NE	Kirchberg
Kirchengasse	NN	Kirchengasse
Kirchenjahr	NN	Kirchenjahr
Kirchgang	NN	Kirchgang
Kirschmarmelade	NN	Kirschmarmelade
Klarinettenquintett	NN	Klarinettenquintett
Klarinettenquintetts	NN	Klarinettenquintetts
Klassenlektüre	NN	Klassenlektüre
Klassenvorstand	NN	Klassenvorstand
Klavieres	NN	Klavier
Klavierkonz	NE	Klavierkonz
Klavierkonzert	NN	Klavierkonzert
Klavierquintett	NN	Klavierquintett
Klaviersonate	NN	Klaviersonate
Klavierwerke	NN	Klavierwerk
Kleinmut	NN	Kleinmut
Klosterfreude	NN	Klosterfreude
Klosterzöglinge	NN	Klosterzöglinge
Knallgasexperiment	NN	Knallgasexperiment
Knaur	NN	Knaur
Knechtenschar	NN	Knechtenschar
Knochenmarkentzündung	NN	Knochenmarkentzündung
Knäkebrod	NN	Knäkebrod
Kocherl	NE	Kocherl
Kochi	NE	Kochi
Koderl	NE	Koderl
Koders	NN	Koders
Kohn	NE	Kohn
Kokoschka	NE	Kokoschka
Kokoschkas	NN	Kokoschkas
Komando	NN	Komando
Komentar	NN	Komentar
Kommando-Befugnis	NN	Kommando-Befugnis
Kommisbrot	NN	Kommisbrot
Komp	ADJA	Komp
Kompaßnadel	NN	Kompassnadel
Konegen	NN	Konegen
Konegen-Ausgabe	NN	Konegen-Ausgabe
Konflikteten	ADJA	Konflikteten
Konzertkarten	NN	Konzertkarte
Konzipist	NN	Konzipist
Kopfwaschung	NN	Kopfwaschung
Korrectur	NN	Korrectur
Kostkind	NN	Kostkind
Kouvert	NN	Kouvert
Kr	NE	Kr
Krak	VVFIN	Krak
Krakow	NE	Krakow
Krankenhaus	NN	Krankenhaus
Krautmann	NE	Krautmann
Kreisleriana	NE	Kreisleriana
Kriegsbeginn	NN	Kriegsbeginn
Kriegsbäckereien	NN	Kriegsbäckereien
Kriegscorrespondent	NN	Kriegscorrespondent
Kriegsdauer	NN	Kriegsdauer
Kriegsdienst	NN	Kriegsdienst
Kriegsdienstleistung	NN	Kriegsdienstleistung
Kriegsfreiwilligen	ADJA	kriegsfreiwillig
Kriegsfreiwilliger	NN	Kriegsfreiwillige
Kriegsgefangener	ADJA	kriegsgefangen
Kriegsmaschine	NN	Kriegsmaschine
Kriegsvorrat	NN	Kriegsvorrat
Kriehuberg	NN	Kriehuberg
Kriehubergasse	NN	Kriehubergasse
Kriemhild	NE	Kriemhild
Krummböck	NE	Krummböck
Kuk	NE	Kuk
Kultur-Epoche	NN	Kultur-Epoche
Kundmanngasse	NN	Kundmanngasse
Kundmanngassenhaus	NN	Kundmanngassenhaus
Kunstamt	NN	Kunstamt
Kunstgegenstände	NN	Kunstgegenstand
Kunstverständnis	NN	Kunstverständnis
Kunz	NE	Kunz
Kupfererze	NN	Kupfererze
Kurfürstendam	NE	Kurfürstendam
Kurfürstendamm	NN	Kurfürstendamm
Kurtl	NE	Kurtl
Köllnerwasser	NN	Köllnerwasser
Königsberg	NE	Königsberg
Königsberger	NE	Königsberger
Königsmahl	NN	Königsmahl
Königssaal	NN	Königssaal
Körperkräfte	NN	Körperkraft
Küchengeschäft	NN	Küchengeschäft
Kügelgen	NN	Kügelgen
Külpe	VVFIN	Külpe
Küsnacht	NN	Küsnacht
LWittgenstein	NE	LWittgenstein
Laborabend	NN	Laborabend
Laborschen	NN	Laborschen
Ladenpakete	NN	Ladenpakete
Lamb	ADJA	Lamb
Lamberie	NN	Lamberie
Landeck	NN	Landeck
Landgut	NN	Landgut
Landregen	NN	Landregen
Landsleute	NN	Landsleute
Landsturm	NN	Landsturm
Landsturm-Aufgebot	NN	Landsturm-Aufgebot
Landsturm-Ingenieur	NN	Landsturm-Ingenieur
Landsturmingenieur	NN	Landsturmingenieur
Landsturmingénier	NN	Landsturmingénier
Landsturmingénieur	NN	Landsturmingénieur
Landstürmern	NN	Landstürmern
Landungsstelle	NN	Landungsstelle
Landwehringénieur	NN	Landwehringénieur
Landwirtschaftslehre	NN	Landwirtschaftslehre
Lans	NN	Lans
Laokoon	NE	Laokoon
Laokoon-Aufsatz	NN	Laokoon-Aufsatz
Lasker-Schüler	NE	Lasker-Schüler
Lassarsalbe	NN	Lassarsalbe
Latzke	NN	Latzke
Lautsch	NN	Lautsch
Lawrence	NE	Lawrence
Leander	NE	Leander
Lebenshaltung	NN	Lebenshaltung
Lebenskraft	NE	Lebenskraft
Lebensmittel	NN	Lebensmittel
Lebensverhältnisse	NN	Lebensverhältnis
Lebenswerk	NN	Lebenswerk
Lebenszeichen	NN	Lebenszeichen
Leberextract	NN	Leberextract
Leberextrakt	NN	Leberextrakt
Lecher	NN	Lecher
Lechner	NE	Lechner
Lechners	NE	Lechner
Lehmbild	NN	Lehmbild
Lehrauftritte	NN	Lehrauftritte
Lehrauftritten	NN	Lehrauftritten
Lehrb	VVFIN	Lehrb
Lehrberuf	NN	Lehrberuf
Lehrberufe	NN	Lehrberuf
Lehrerbildungsanstalt	NN	Lehrerbildungsanstalt
Lehrerei	NN	Lehrerei
Lehrerinnenzeit	NN	Lehrerinnenzeit
Lehrerzeitschrift	NN	Lehrerzeitschrift
Lehrplan	NN	Lehrplan
Lehrversuch	NN	Lehrversuch
Leichtverwundete	ADJA	Leichtverwundete
Leihbedingungen	NN	Leihbedingungen
Leipzig	NE	Leipzig
Lembergs	NE	Lembergs
Leonoren-Ouvertüre	NN	Leonoren-Ouvertüre
Leopoldine	NE	Leopoldine
Leporel	NE	Leporel
Lesebuch	NN	Lesebuch
Lesebücher	NN	Lesebuch
Leserkreis	NN	Leserkreis
Lesesaal	NN	Lesesaal
Leteiners	NN	Leteiners
Lettowitz	NE	Lettowitz
Lewes	NE	Lewes
Lhw	NE	Lhw
Librarian	NN	Librarian
Lichtenegger	NN	Lichtenegger
Liebenswürdigkeit	NN	Liebenswürdigkeit
Liebesdienst	NN	Liebesdienst
Liebeszeichen	NN	Liebeszeichen
Lieblingsspeisen	NN	Lieblingsspeise
Lieblingswörter	NN	Lieblingswort
Liedertafel	NN	Liedertafel
Lilies	NE	Lilies
Lilliput	NE	Lilliput
Lindner	NE	Lindner
Lissabon	NE	Lissabon
Livius	NE	Livius
Lixl's	VVFIN	Lixl's
Loewenstein	NE	Loewenstein
Lohengrin	NN	Lohengrin
Loos'sche	NN	Loos'sche
Lovrana	NE	Lovrana
Lt	NE	Lt
Ltnd	NE	Ltnd
Lucifer	NE	Lucifer
Lucius	NE	Lucius
Ludw	NE	Ludw
Luftfahrtruppen	NN	Luftfahrtruppen
Luise	NE	Luise
Luki	NN	Luki
Lungenentzündung	NN	Lungenentzündung
Luxuskappe	NN	Luxuskappe
Lydia	NE	Lydia
Lyrik-Vorträgen	NN	Lyrik-Vorträgen
Maasse	NN	Maasse
Mackensen	NE	Mackensen
Mackensens	NE	Mackensens
Madras	NE	Madras
Madrid	NE	Madrid
Magenfesttag	NN	Magenfesttag
Maier	NE	Maier
Malaka	NE	Malaka
Malting	NE	Malting
Manfred	NE	Manfred
Mannheimer	NN	Mannheimer
Manuscript	NN	Manuscript
Manuscripte	NN	Manuscripte
Manuskr	NN	Manuskr
Mareile	NE	Mareile
Mareiles	NE	Mareiles
Margaret	NE	Margaret
Margarete	NE	Margarete
Margaretenstraße	NE	Margaretenstraße
Margarette	NE	Margarette
Mariahilferstr	NE	Mariahilferstr
Mariam	NE	Mariam
Mariamne	NN	Mariamne
Mariazellerbahn	NN	Mariazellerbahn
Marienbad	NN	Marienbad
Marionettentheater	NN	Marionettentheater
Marschbataillon	NN	Marschbataillon
Marschik	NN	Marschik
Marschübungen	NN	Marschübungen
Mary	NE	Mary
Masarykpl	NE	Masarykpl
Masarykplatz	NN	Masarykplatz
Maschin	NN	Maschin
Maschinen-Ingenieure	NN	Maschinen-Ingenieure
Maschingeschriebenen	ADJA	Maschingeschriebenen
Maschingeschriebenes	NN	Maschingeschriebenes
Maschinschreiben	ADJA	Maschinschreiben
Massenteilchens	NN	Massenteilchens
Mastkur	NN	Mastkur
Mathematikstudium	NN	Mathematikstudium
Matraze	NN	Matraze
Mauritzplatz	NN	Mauritzplatz
Maurizhause	NE	Maurizhause
Maxls	NE	Maxls
Mayer	NE	Mayer
Mayonaise	NN	Mayonaise
Maßstabe	NN	Maßstab
Mecklenb	VVFIN	Mecklenb
Medea	NE	Medea
Medik	ADJA	Medik
Medikamenten-Akzessist	NN	Medikamenten-Akzessist
Mehlspeise	NN	Mehlspeise
Meinungsaustausch	NN	Meinungsaustausch
Meistersingerüvertüre	NN	Meistersingerüvertüre
Meisterwerk	NN	Meisterwerk
Meistrik	NN	Meistrik
Menscheit	NN	Menscheit
Menschenhand	NN	Menschenhand
Menschenkind	NN	Menschenkind
Menschenmund	NN	Menschenmund
Metalgegenstand	NN	Metalgegenstand
Meyer	NE	Meyer
Michal	NE	Michal
Mietamt	NN	Mietamt
Milchgasse	NN	Milchgasse
Miles-Platting	NE	Miles-Platting
Militär-Ingenieur	NN	Militär-Ingenieur
Militär-Kommando	NN	Militär-Kommando
Militärdienst	NN	Militärdienst
Militärdienstes	NN	Militärdienst
Militärdienstjahr	NN	Militärdienstjahr
Militärkommando	NN	Militärkommando
Militärperson	NN	Militärperson
Mima	NE	Mima
Mindestteilbetrag	NN	Mindestteilbetrag
Minings	NN	Minings
Ministerialbeamter	NN	Ministerialbeamte
Minning	NE	Minning
Misère	NE	Misère
Mitarbeiter	NN	Mitarbeiter
Mitarbeitern	NN	Mitarbeiter
Mitbesitzer	NN	Mitbesitzer
Mitinhaber	NN	Mitinhaber
Mitleidenschaft	NN	Mitleidenschaft
Mittagszug	NN	Mittagszug
Mittellinie	NN	Mittellinie
Mittelohrkatarrh	NN	Mittelohrkatarrh
Mittelschullehrbuch	NN	Mittelschullehrbuch
Mittelschulprofessoren	NN	Mittelschulprofessoren
Mittelschüler	NE	Mittelschüler
Mittelsätze	NN	Mittelsatz
Mitterbach	NN	Mitterbach
Mittlerweile	ADV	mittlerweile
Mitwelt	NN	Mitwelt
Molenstraat	NN	Molenstraat
Molè	NE	Molè
Mombert	NE	Mombert
Monatsraten	NN	Monatsrate
Moralprediger	NN	Moralprediger
Moravia	NE	Moravia
Mordsphilister	NN	Mordsphilister
Morgenlandes	NN	Morgenland
Morgenrot-Scheid	NN	Morgenrot-Scheid
Moritz	NE	Moritz
Moskau	NE	Moskau
Mscrpt	NE	Mscrpt
Mundmunition	NN	Mundmunition
Musikabend	NN	Musikabend
Musikbetrachtungen	NN	Musikbetrachtungen
Musikprobe	NN	Musikprobe
Muth	NE	Muth
Mährisch-Schönberg	NE	Mährisch-Schönberg
Märchentraum	NN	Märchentraum
Möbelhändler	NN	Möbelhändler
Mörike	NE	Mörike
Mörikes	NE	Mörike
Mühlau	NE	Mühlau
Münchhausens	NE	Münchhausens
Nacherzählung	NN	Nacherzählung
Nachmittage	NN	Nachmittag
Nachschrift	NN	Nachschrift
Nachthemden	NN	Nachthemd
Nachwirkung	NN	Nachwirkung
Nagy	NE	Nagy
Nahrungsmittel	NN	Nahrungsmittel
Natan	NN	Natan
Natriumphosphat	NN	Natriumphosphat
Naturgeschichtsbuch	NN	Naturgeschichtsbuch
Naturphilosophie	NN	Naturphilosophie
Nebensatzes	NN	Nebensatzes
Nebenumstand	NN	Nebenumstand
Nebenumstände	NN	Nebenumstände
Nervenbündel	NN	Nervenbündel
Nervenkranke	ADJA	nervenkrank
Nervenschmerzen	NN	Nervenschmerz
Nervenshock	NN	Nervenshock
Netzgewebe	NN	Netzgewebe
Neu-Waldegg	NE	Neu-Waldegg
Neuburg	NN	Neuburg
Neugebauer	NN	Neugebauer
Neujahrslied	NN	Neujahrslied
Neujahrswünsche	NN	Neujahrswunsch
Neunkirchen	NN	Neunkirche
Neuraths	NE	Neuraths
Neururer	ADJA	Neururer
Neuwaldegger	NN	Neuwaldegger
Neuzeit	NN	Neuzeit
Nicht-Gefühl	NN	Nicht-Gefühl
Nicht-Schreiben	ADJA	Nicht-Schreiben
Nichtturist	NN	Nichtturist
Nieder-Oesterreich	NN	Nieder-Oesterreich
Nieder-Österr	NN	Nieder-Österr
Nieder-Österreich	NN	Nieder-Österreich
Niedergeschlagensein	NN	Niedergeschlagensein
Niederigkeit	NN	Niederigkeit
Niederöst	ADJA	Niederöst
Niederösterreichische	NN	Niederösterreichische
No1	VVFIN	No1
Notify	NE	Notify
Notitzen	ADJA	Notitzen
Nro	NN	Nro
N°	NE	N°
Nächstens	NE	Nächstens
Nächstes	ADJA	nah
Nächststehenden	ADJA	Nächststehenden
Oberarmen	NN	Oberarm
Obergymnasien	NN	Obergymnasien
Obergymnasium	NN	Obergymnasium
Obergärtner	NE	Obergärtner
Oberkofler	NN	Oberkofler
Oberköchin	NN	Oberköchin
Oberl	NE	Oberl
Oberlehrer	NN	Oberlehrer
Oberlehrers	NN	Oberlehrer
Oberleitner	NN	Oberleitner
Oberleitnerin	NN	Oberleitnerin
Oberleut	NN	Oberleut
Oberlicht	NN	Oberlicht
Oberoffizial	NN	Oberoffizial
Oberring	NN	Oberring
Obersakramenter	NN	Obersakramenter
Obj	NE	Obj
Observers	NN	Observers
Oc	NE	Oc
Octav	NE	Octav
Oderberg	NN	Oderberg
Oe	XY	Ö
Oeffentlichkeit	NN	Oeffentlichkeit
Oeltanks	NN	Oeltanks
Oer	NE	Oer
Oesterr	NN	Oesterr
Oesterreich	NN	Oesterreich
Oesterreich-Galizien	NE	Oesterreich-Galizien
Oesterreich-Ungarn	NE	Oesterreich-Ungarn
Oesterreichische	ADJA	Oesterreichische
Oesterreichischen	ADJA	Oesterreichischen
Oesterreichisches	ADJA	Oesterreichisches
Ohrenspezialisten	NN	Ohrenspezialisten
Okkup	NN	Okkup
Okt	ADJA	Okt
Oldham	NN	Oldham
Olmütz	NE	Olmütz
Olmützer	NN	Olmützer
Olmüz	NE	Olmüz
Olomouc	NE	Olomouc
Olso	NE	Olso
Operngasse	NN	Operngasse
Opernsängerin	NN	Opernsängerin
Optime	ADJA	Optime
Orakelspruch	NN	Orakelspruch
Orgelalbum	NN	Orgelalbum
Orgelstücke	NN	Orgelstück
Ortschulrat	NN	Ortschulrat
Ortswechsel	NN	Ortswechsel
Ort	NN	Ort
Oskar	NE	Oskar
Osterbrief	NN	Osterbrief
Osterjause	NN	Osterjause
Ostsee	NN	Ostsee
Ostwald	NN	Ostwald
Ostwaldschen	NN	Ostwaldschen
Otterth	NE	Otterth
Otterthaler	NE	Otterthaler
Ouverture	NN	Ouverture
Pabenschwand	NN	Pabenschwand
Pabenschwandt	ADJD	Pabenschwandt
Packete	NN	Packete
Packpapier	NN	Packpapier
Paketchen	NN	Paketchen
Palmenhauses	NN	Palmenhaus
Palästina's	NE	Palästina's
Panem	NN	Panem
Pappendeckel	NN	Pappendeckel
Parkettfussböden	NN	Parkettfußboden
Parkgate	NN	Parkgate
Parteiwesen	NN	Parteiwesen
Parzival	NN	Parzival
Patrick's	NE	Patrick's
Patricks	NE	Patrick
Pauls	NE	Paul
Pauls	NE	Paul
Paß-Formalitäten	NN	Paß-Formalitäten
Paßbehörde	NN	Passbehörde
Peking	NE	Peking
Pelzrock	NN	Pelzrock
Pennersdorfer	NN	Pennersdorfer
Perry	NE	Perry
Pezzlgasse	NN	Pezzlgasse
Pfarrersköchin	NN	Pfarrersköchin
Pfarrkirche	NN	Pfarrkirche
Pflichttreue	ADJA	pflichttreu
Pfundpaket	NN	Pfundpaket
Pfundpaketchen	NN	Pfundpaketchen
Phil	NE	Phil
Philipp	NE	Philipp
Philosophie-Professor	NN	Philosophie-Professor
Philosophieprofessor	NN	Philosophieprofessor
Philosophieprofessoren	NN	Philosophieprofessor
Phrasenhaftigkeit	NN	Phrasenhaftigkeit
Physikalismus	NN	Physikalismus
Planetensystem	NN	Planetensystem
Platzfrage	NN	Platzfrage
Poincaré	NN	Poincaré
Pol-paaren	NN	Pol-paaren
Pomona	NE	Pomona
Portosatzes	NN	Portosatzes
Porträtkopf	NN	Porträtkopf
Postamt	NN	Postamt
Postanweisung	NN	Postanweisung
Postbeamte	NN	Postbeamte
Postbote	NN	Postbote
Postfach	NN	Postfach
Postgate	ADJA	Postgate
Postkarte	NN	Postkarte
Postkarten	NN	Postkarte
Postl	NE	Postl
Postlagernd	ADJD	postlagernd
Postnummer	NN	Postnummer
Postrekening	NN	Postrekening
Postverbindung	NN	Postverbindung
Preisnachlaß	NN	Preisnachlass
Prioritaetsgezaenk	NN	Prioritaetsgezaenk
Prioritätsschweinereien	NN	Prioritätsschweinereien
Prioritätsstreitigkeit	NN	Prioritätsstreitigkeit
Prisoners	NE	Prisoners
Pristly	NE	Pristly
Probedruck	NN	Probedruck
Prof	NE	Prof
Professorenkollegium	NN	Professorenkollegien
Proffessor	NN	Proffessor
Prosasatzes	NN	Prosasatzes
Prov	NE	Prov
Przemysl	NE	Przemysl
Psychol	ADJA	Psychol
Publikationsabsichten	NN	Publikationsabsichten
Puchberg	NN	Puchberg
Quahl	NN	Quahl
Quibbs	NN	Quibbs
Quo	NN	Quo
Raach	NE	Raach
Radnitzky	NE	Radnitzky
Rainer	NE	Rainer
Ralph	NE	Ralph
Rangsklasse	NN	Rangsklasse
Rasierklingen	NN	Rasierklinge
Rassenproblem	NN	Rassenproblem
Rasumofskygasse	NN	Rasumofskygasse
Rasumovskygasse	NN	Rasumovskygasse
Ratgeber	NN	Ratgeber
Raubbau	NN	Raubbau
Raubdruck	NN	Raubdruck
Raubthiere	NN	Raubthiere
Raubvogel	NN	Raubvogel
Rauhensteingasse	NN	Rauhensteingasse
Realschulmatura	NN	Realschulmatura
Realwissensch	NN	Realwissensch
Rebnis	NN	Rebnis
Rechtschreiber	NN	Rechtschreiber
Rechtschreibewörterbuches	NN	Rechtschreibewörterbuches
Rechtswissenschaft	NN	Rechtswissenschaft
Reclam	NE	Reclam
Reclam-Bestellung	NN	Reclam-Bestellung
Reductions-Axiom	NN	Reductions-Axiom
Regmt	NN	Regmt
Reichenbach	NE	Reichenbach
Reichmann	NE	Reichmann
Reichsdeutscher	ADJA	reichsdeutsch
Reigenvortrag	NN	Reigenvortrag
Reihn	NN	Reihn
Reisebedingungen	NN	Reisebedingung
Reklam	NE	Reklam
Religionsprofessor	NN	Religionsprofessor
Religionsprofessors	NN	Religionsprofessors
Rendel	NE	Rendel
Rendels	NN	Rendels
Reparaturfähigkeiten	NN	Reparaturfähigkeiten
Reparaturwerkstätte	NN	Reparaturwerkstätte
Reservemannes	NN	Reservemannes
Respinger	NN	Respinger
Reykavik	NN	Reykavik
Rgt	NN	Rgt
Richard	NE	Richard
Riesenarbeit	NN	Riesenarbeit
Riesenlaib	NN	Riesenlaib
Riesenstück	NN	Riesenstück
Rilke's	NE	Rilke's
Rilkes	NE	Rilkes
Rimmer	NE	Rimmer
Risico	NE	Risico
Ritchies	NE	Ritchies
Rivoli	NE	Rivoli
Rodin	NE	Rodin
Rosenau	NE	Rosenau
Ross's	NE	Ross's
Rosthorn	NE	Rosthorn
Rote-Kreuz-Schwestern	NN	Rote-Kreuz-Schwestern
Rud	NE	Rud
Rudolf	NE	Rudolf
Rusch-Herdegen-Tiechl	VVFIN	Rusch-Herdegen-Tiechl
Russel	NE	Russel
Russl	NE	Russl
Russland	NE	Russland
Röck	NE	Röck
Rückreise	NN	Rückreise
Rücksendung	NN	Rücksendung
Sachgemäßheit	NN	Sachgemäßheit
Sakramenter	ADJA	Sakramenter
Saldokonto	NN	Saldokonto
Salierische	NN	Salierische
Salzburg	NE	Salzburg
Salzer	NN	Salzer
Salzers	NN	Salzers
Sanctificetur	NN	Sanctificetur
Sch	ADJA	Sch
Schabauer	NN	Schabauer
Schadenfreude	NN	Schadenfreude
Schaffenskraft	NE	Schaffenskraft
Schatzkästlein	NN	Schatzkästlein
Schauspielertalente	NN	Schauspielertalente
Scheingründe	NN	Scheingründe
Scheinwerferkommandant	NN	Scheinwerferkommandant
Scheinwerfern	NN	Scheinwerfer
Schicksalsfügung	NN	Schicksalsfügung
Schleffer	NN	Schleffer
Schlesien	NE	Schlesien
Schliemann	NN	Schliemann
Schlittenfahrt	NN	Schlittenfahrt
Schlittschuhläufer	NN	Schlittschuhläufer
Schlosserfirma	NN	Schlosserfirma
Schlögl	NE	Schlögl
Schlüsselbein	NN	Schlüsselbein
Schmidt	NE	Schmidt
Schmiedefeuer	NN	Schmiedefeuer
Schneeschicht	NN	Schneeschicht
Schnurspringen	ADJA	Schnurspringen
Schoberkarten	NN	Schoberkarten
Schockwirkungen	NN	Schockwirkung
Schokoladenbrief	NN	Schokoladenbrief
Schokoladenbriefe	NN	Schokoladenbriefe
Schokoladenpaket	NN	Schokoladenpaket
Schokoladetrüffel	NN	Schokoladetrüffel
Scholze-Schmeil	NN	Scholze-Schmeil
Schreibseeligkeit	NN	Schreibseeligkeit
Schrien	ADJA	Schrien
Schriftchen	NN	Schriftchen
Schriftleitung	NN	Schriftleitung
Schulanfang	NN	Schulanfang
Schulangelegenheiten	NN	Schulangelegenheit
Schularbeit	NN	Schularbeit
Schulatlas	NN	Schulatlas
Schulausgaben	NN	Schulausgaben
Schulbuchverlag	NN	Schulbuchverlag
Schulbücherverlag	NN	Schulbücherverlag
Schulbücherverlags	NN	Schulbücherverlags
Schulgeldbefreiungskonferenz	NN	Schulgeldbefreiungskonferenz
Schulhandkarten	NN	Schulhandkarten
Schuljahr	NN	Schuljahr
Schulkinder	NN	Schulkind
Schulleitung	NN	Schulleitung
Schulnachrichten	NN	Schulnachrichten
Schulreform	NN	Schulreform
Schulschluß	NN	Schulschluss
Schulzeit	NN	Schulzeit
Schw	VVFIN	Schw
Schwaighofer	NE	Schwaighofer
Schwarzwald	NN	Schwarzwald
Schwarzwalds	NN	Schwarzwald
Schweinehund	NN	Schweinehund
Schwiegertochter	NN	Schwiegertochter
Schwächezustand	NN	Schwächezustand
Schönbrunn	NN	Schönbrunn
Schülerlade	NN	Schülerlade
Schülerproduktion	NN	Schülerproduktion
Schüttelvers	NN	Schüttelvers
Schützeneskadr	NE	Schützeneskadr
Sectionschef	NN	Sectionschef
Seehund	NN	Seehund
Seidenpapier	NN	Seidenpapier
Seidl	NE	Seidl
Seitenwegen	NN	Seitenwegen
Seitenziffern	NN	Seitenziffern
Seither	ADV	seither
Selbstbespiegelung	NN	Selbstbespiegelung
Selbstbetrug	NN	Selbstbetrug
Selbstentäußerung	NN	Selbstentäußerung
Selbstgefühl	NN	Selbstgefühl
Selbstkritik	NN	Selbstkritik
Selbstmitleid	NN	Selbstmitleid
Selbstmordgedanken	NN	Selbstmordgedanke
Selbstmordgedankens	NN	Selbstmordgedankens
Selbstverlag	NN	Selbstverlag
Selbstvorwurf	NN	Selbstvorwurf
Semesterferien	NN	Semesterferien
Semestralferien	NN	Semestralferien
Sense-Data	NE	Sense-Data
Servitengasse	NN	Servitengasse
Servus	NE	Servus
Shawl	NE	Shawl
Sich-Abwenden	ADJA	Sich-Abwenden
Silbengenauigkeit	NN	Silbengenauigkeit
Silvester-Feier	NN	Silvester-Feier
Sjögren	NE	Sjögren
Sjögrens	NN	Sjögrens
Skitze	NN	Skitze
Skitzen	NN	Skitzen
Skjölden	ADJA	Skjölden
Snapshots	NN	Snapshots
Sodawasser	NN	Sodawasser
Sogn	NN	Sogn
Sommeraufenthalt	NN	Sommeraufenthalt
Sommerbeschäftigung	NN	Sommerbeschäftigung
Sommerferien	NN	Sommerferien
Sommerfrische	ADJA	sommerfrisch
Sommernachtstraum	NN	Sommernachtstraum
Sommernachtstraums	NN	Sommernachtstraum
Sommersemester	NN	Sommersemester
Sommertätigkeit	NN	Sommertätigkeit
Sonderabdruck	NN	Sonderabdruck
Sonderabdruckes	NN	Sonderabdruckes
Sonderdrucke	NN	Sonderdruck
Sonnabend	NN	Sonnabend
Sonnensystem	NN	Sonnensystem
Sonntag-Nachmittag	NN	Sonntag-Nachmittag
Sossima	NE	Sossima
Sottotenente	NN	Sottotenente
Speisebrocken	NN	Speisebrocken
Speisezimmer	NE	Speisezimmer
Speisezimmerbild	NN	Speisezimmerbild
Spielstube	NN	Spielstube
Spit	NN	Spit
Sprechtag	NN	Sprechtag
Spürsinn	NN	Spürsinn
Staab	ADV	Staab
Staatenentw	ADJA	Staatenentw
Staatsbürgers	NN	Staatsbürger
Staatserziehungsanstalt	NN	Staatserziehungsanstalt
Stadtklima	NN	Stadtklima
Stadtteilen	NN	Stadtteil
Stanford	NE	Stanford
Stanislaus	NE	Stanislaus
Staretz	NN	Staretz
Starez	NN	Starez
Stationsschwester	NN	Stationsschwester
Statthalterei-Archiv	NN	Statthalterei-Archiv
Staubschichten	NN	Staubschicht
Stickler	NN	Stickler
Stillschweigens	NN	Stillschweigen
Stockerau	ADJA	Stockerau
Stockerts	NN	Stockerts
Stockwerke	NN	Stockwerk
Stoessl	NE	Stoessl
Stonborough	NE	Stonborough
Stoßeschen	NN	Stoßeschen
Str	NE	Str
Strasser	NN	Strasser
Strathaird	NN	Strathaird
Straußgasse	NN	Straußgasse
Straußische	NN	Straußische
Straßburg	NE	Straßburg
Straßer	NN	Straßer
Striglin	NN	Striglin
Strohhalme	NN	Strohhalm
Strohsack	NN	Strohsack
Studentenmaterial	NN	Studentenmaterial
Stultitiae	NN	Stultitiae
Sturmwind	NN	Sturmwind
Suspens	NN	Suspens
Sylvesterfeier	NN	Sylvesterfeier
Szczepanska	NE	Szczepanska
Szczépanska	NE	Szczépanska
Szybínski	NE	Szybínski
Sächs	NN	Sächs
Südbahnhof	NN	Südbahnhof
Südfront	NN	Südfront
Südfrüchte	NN	Südfrucht
Südwestfront	NN	Südwestfront
Tablettensendung	NN	Tablettensendung
Taeglich	ADJD	Taeglich
Tafelrunde	NN	Tafelrunde
Tagesmühe	NN	Tagesmühe
Tagore	NN	Tagore
Talkstündchen	NN	Talkstündchen
Taschenspielerisches	NN	Taschenspielerisches
Techn	NN	Techn
Tedesca	NE	Tedesca
Tedesco	NN	Tedesco
Teilpublikationen	NN	Teilpublikationen
Tel	NE	Tel
Telefoon	NN	Telefoon
Telegramme	NN	Telegramm
Telegramms	NN	Telegramm
Telegrammstyls	ADJA	Telegrammstyls
Telgr	NN	Telgr
Tempski	NN	Tempski
Tempsky	NE	Tempsky
Tennisspieler	NN	Tennisspieler
Ternitz	NE	Ternitz
Tesar	NE	Tesar
Theben	NE	Theben
Theilnahme	NN	Theilnahme
Theodor	NE	Theodor
Theos	NE	Theo
Thierinstinkte	NE	Thierinstinkte
Thun	NN	Thun
Thätigkeit	NN	Thätigkeit
Thüre	NN	Thüre
Tiefschlaf	NN	Tiefschlaf
Tiergartens	NN	Tiergarten
Tir	NE	Tir
Tirol	NE	Tirol
Tischlein	NN	Tischlein
Tischlerwerkstätte	NN	Tischlerwerkstätte
Tittel	NN	Tittel
Tl	NE	Tl
Todesengel	NE	Todesengel
Tolstoij	NE	Tolstoij
Tonkünstlerorchesters	NN	Tonkünstlerorchesters
Torschluss	NN	Torschluss
Totenhaus	NN	Totenhaus
Trackl	NN	Trackl
Tragwilligkeit	NN	Tragwilligkeit
Traiskirchen	NN	Traiskirchen
Trakl's	VVFIN	Trakl's
Trattenb	ADJA	Trattenb
Trattenbach	NN	Trattenbach
Trattenbacher	ADJA	Trattenbacher
Traumleib	NN	Traumleib
Treibrieben	NN	Treibrieben
Trient	NE	Trient
Triestiner	ADJA	Triestiner
Trin	NN	Trin
Trinitat	NN	Trinitat
Tschischek	NN	Tschischek
Tubutsch	NN	Tubutsch
Tugendbündlerhotel	NN	Tugendbündlerhotel
Turnschule	NN	Turnschule
Tyranei	NN	Tyranei
U-bootkrieges	NN	U-bootkrieges
Uebel	NN	Uebel
Uebelstand	NN	Uebelstand
Ueberdies	NN	Ueberdies
Uebereinstimmung	NN	Uebereinstimmung
Uebernehmen	NN	Uebernehmen
Uebersendung	NN	Uebersendung
Ueberwindung	NN	Ueberwindung
Ueberzahl	NN	Ueberzahl
Ueberzeugung	NN	Ueberzeugung
Uebrigens	NN	Uebrigens
Uebung	NN	Uebung
Uh	ITJ	uh
Uhland	NE	Uhland
Uhlandsche	ADJA	Uhlandsche
Umsichgreifen	NN	Umsichgreifen
Unanständiges	ADJA	unanständig
Ung	NE	Ung
Ungewissheit	NN	Ungewissheit
Ungründlichkeit	NN	Ungründlichkeit
Uninformierten	NN	Uninformierten
Univ	ADJA	Univ
Universitäts-Professor	NN	Universitäts-Professor
Universitätsprofessor	NN	Universitätsprofessor
Unterdessen	ADV	unterdessen
Unterhaltsbeitrag	NN	Unterhaltsbeitrag
Unterhaltungen	NN	Unterhaltung
Unterhosen	NN	Unterhose
Unterjäger	NN	Unterjäger
Unterlehrerin	NN	Unterlehrerin
Unterleib	NN	Unterleib
Unternehmungslust	NN	Unternehmungslust
Unteroffizier	NN	Unteroffizier
Unterseeboot	NN	Unterseeboot
Urania	NE	Urania
Urania-Organisation	NN	Urania-Organisation
Uraniabesucher	NN	Uraniabesucher
Urgefühle	NN	Urgefühle
Urlaubszeit	NN	Urlaubszeit
Urteilskraft	NE	Urteilskraft
VIIl	NN	VIIl
Valentin	NE	Valentin
Vapex	NE	Vapex
Variationensatz	NN	Variationensatz
Vaterlande	NN	Vaterland
Veit	NE	Veit
Veitgasse	NN	Veitgasse
Venetianischen	ADJA	venetianisch
Verantwortlichkeitsgefühl	NN	Verantwortlichkeitsgefühl
Verbandzeug	NN	Verbandzeug
Verfuegung	NN	Verfuegung
Verlagsangelegenheit	NN	Verlagsangelegenheit
Verlegenheitsgesprächen	NN	Verlegenheitsgesprächen
Veroeffentlichung	NE	Veroeffentlichung
Verona	NE	Verona
Verteilungsvorschläge	NN	Verteilungsvorschläge
Vertrauensmänner	NN	Vertrauensmann
Vesuv	NN	Vesuv
Vesuvs	NN	Vesuv
Viaduktgasse	NN	Viaduktgasse
Victor	NE	Victor
Vieleicht	NN	Vieleicht
Vierundzwanzigstundenundnichtlängerbesuche	NN	Vierundzwanzigstundenundnichtlängerbesuche
Viktor	NE	Viktor
Vineta	NE	Vineta
Vitaminpräparat	NN	Vitaminpräparat
Vogelwelt	NN	Vogelwelt
Vogesen	NN	Vogesen
Vojeslav	NE	Vojeslav
Vokalquartett	NN	Vokalquartett
Volkmann-Leander	NE	Volkmann-Leander
Volkserzählungen	NN	Volkserzählung
Volksgartenkaffee	NN	Volksgartenkaffee
Volkshochschule	NN	Volkshochschule
Volkslieder	NN	Volkslied
Volksschullehrer	NN	Volksschullehrer
Volksweisen	NN	Volksweise
Volldampf	NN	Volldampf
Vorallem	NN	Vorallem
Vorbereitungsjahr	NN	Vorbereitungsjahr
Vorhängschloß	NN	Vorhängschloß
Vormerkkalender	NN	Vormerkkalender
Vorstellungsgruppen	NN	Vorstellungsgruppen
Völkerfrieden	ADJA	Völkerfrieden
Vöslauergasse	NN	Vöslauergasse
Wagneranklänge	NN	Wagneranklänge
Wahlzettel	NN	Wahlzettel
Wahrheitssucher	NN	Wahrheitssucher
Wahrheitstheorie	NN	Wahrheitstheorie
Waismann	NN	Waismann
Waissmann	NN	Waissmann
Waißmann	NE	Waißmann
Waißmann-Sache	NN	Waißmann-Sache
Waißmanns	NE	Waißmanns
Waldmark	NE	Waldmark
Waldmarkschule	NN	Waldmarkschule
Walfisch	NN	Walfisch
Wandlungsfähigkeit	NN	Wandlungsfähigkeit
Wangensbach	NN	Wangensbach
Wanicek	NE	Wanicek
Wankelmut	NN	Wankelmut
Waschgelegenheiten	NN	Waschgelegenheit
Wassagensie	NN	Wassagensie
Weichsel-Schiff	NN	Weichsel-Schiff
Weihnachtsbesuch	NN	Weihnachtsbesuch
Weihnachtsfest	NN	Weihnachtsfest
Weihnachtsmann	NE	Weihnachtsmann
Weihnachtspaket	NN	Weihnachtspaket
Weihnachtsstimmung	NN	Weihnachtsstimmung
Weihnachtstisch	NN	Weihnachtstisch
Weihnachtsurlaub	NN	Weihnachtsurlaub
Weinachten	NN	Weinachten
Weinberger	NE	Weinberger
Weiterbeförderung	NN	Weiterbeförderung
Weizenmehlzeit	NN	Weizenmehlzeit
Weißdorn	NE	Weißdorn
Welthandel	NN	Welthandel
Weniget	VVFIN	Weniget
Werkstaette	NN	Werkstaette
Werkstättearbeit	NN	Werkstättearbeit
Werkstättenzug	NN	Werkstättenzug
Werkzeughandlung	NN	Werkzeughandlung
Widerstandskraft	NE	Widerstandskraft
Widerwillen	NN	Widerwille
Wiedererkennungsurteil	NN	Wiedererkennungsurteil
Wiedereroberung	NN	Wiedereroberung
Wiederherstellung	NN	Wiederherstellung
Wiedersehn	NN	Wiedersehn
Wiesenberg	NE	Wiesenberg
Wiesenberger	NE	Wiesenberger
Willensschwäche	NN	Willensschwäche
Wire	NN	Wire
Wirkungskreis	NN	Wirkungskreis
Wirtschaftsfräulein	NN	Wirtschaftsfräulein
Wismar	NE	Wismar
Wismarschen	NN	Wismarschen
Wissenswerte	ADJA	wissenswert
Wochenstunden	NN	Wochenstunde
Wohlergehen	NN	Wohlergehen
Wohlergehn	ADJA	Wohlergehn
Wohlgeboren	ADJA	Wohlgeboren
Wohlwollen	NN	Wohlwollen
Wohnungfinden	NN	Wohnungfinden
Wohnungseinrichtung	NN	Wohnungseinrichtung
Wohnungswechsel	NN	Wohnungswechsel
Woletz	NN	Woletz
Wolle-Fäden	NN	Wolle-Fäden
Wollheim	NN	Wollheim
Wollzeile	NN	Wollzeile
Woltat	NN	Woltat
Wonne-Zagen	NN	Wonne-Zagen
Wounded	NE	Wounded
Wärmstens	NN	Wärmstens
Wörterb	NN	Wörterb
Wörterbuchseite	NN	Wörterbuchseite
Würtemberger	NE	Würtemberger
Xxiii	NE	Xxiii
Zahnbürste	NN	Zahnbürste
Zahnstocher	NN	Zahnstocher
Zartgefühl	NN	Zartgefühl
Zauberleuchtturm	NN	Zauberleuchtturm
Zch	NE	Zch
Zeichensaal	NN	Zeichensaal
Zeitaltern	NN	Zeitalter
Zeitungsartikel	NN	Zeitungsartikel
Zeitungsausschnitt	NN	Zeitungsausschnitt
Zeitungsausschnitte	NN	Zeitungsausschnitt
Zeitverhältnisse	NN	Zeitverhältnis
Zielienewski	NN	Zielienewski
Zimmerfeuerwerk	NN	Zimmerfeuerwerk
Zimmergesell	NN	Zimmergesell
Zimmermann	NE	Zimmermann
Zimmermanns	NE	Zimmermann
Zirkularbrief	NN	Zirkularbrief
Zirl	NN	Zirl
Zukunftspläne	NN	Zukunftsplan
Zunftgenossen	NN	Zunftgenosse
Zurechnungsfähigkeit	NN	Zurechnungsfähigkeit
Zurücksetzung	NN	Zurücksetzung
Zusammenhand	NN	Zusammenhand
Zusammenstöße	NN	Zusammenstoß
Zwettl	NE	Zwettl
Zwinz	NE	Zwinz
Zwischenpause	NN	Zwischenpause
Zürich	NE	Zürich
ab-Bezeichnungsw	ADJD	ab-Bezeichnungsw
abgesendet	VVPP	absenden
absendete	ADJA	absendete
absit	NN	absit
absolvieren	VVFIN	absolvieren
abzukanzeln	VVIZU	abkanzeln
abzuliefern	VVIZU	abliefern
aenderten	ADJD	aenderten
aesthetischen	ADJA	aesthetischen
ageo	NN	ageo
allabendlich	ADV	allabendlich
allererst	ADJD	allererst
allerliebste	ADJA	allerlieb
allg	NN	allg
allso	ADV	allso
allzulanger	ADJD	allzulanger
allzuviel	PIS	allzuviel
altmodischen	ADJA	altmodisch
ambulabant	ADJA	ambulabant
anderswohin	ADV	anderswohin
andeutungsweise	ADJA	andeutungsweise
angeli	NE	angeli
angesch-n	NE	angesch-n
angiebst	ADJD	angiebst
ankahm	VVFIN	ankahm
annum	NN	annum
anstaendig	ADJD	anstaendig
anständigem	ADJA	anständig
anständiges	ADJA	anständig
anzuvertrauen	VVIZU	anvertrauen
aquain	NE	aquain
arangiert	ADJA	arangiert
armseliger	ADJA	armselig
athmen	NN	athmen
auf's	VVFIN	auf's
aufmerksamgemacht	ADJA	aufmerksamgemacht
auf’s	ADJA	auf’s
auserlesenen	ADJA	auserlesen
ausgeschloßen	ADJA	ausgeschloßen
aussen	ADJD	außenßen
ausser	APPR	außer
ausserhalb	ADV	außerhalb
ausserordentlich	ADJD	außerordentlich
auszubessern	VVIZU	ausbessern
auszuersehen	ADJA	auszuersehen
auszuruhn	NN	auszuruhn
außenherum	ADV	außenherum
außer-musikalische	ADJA	außer-musikalische
außergewöhnlichen	ADJA	außergewöhnlich
außerweltlichen	ADJA	außerweltlichen
balde	NN	balde
basta	ITJ	basta
baz	ADJA	baz
beherzigenswert	NN	beherzigenswert
behälst	ADJD	behälst
bekanntmachst	VVFIN	bekanntmachst
bemühn	ADJA	bemühn
bene	NN	bene
bereitwilligst	VVFIN	bereitwilligen
berggetürmtes	ADJA	berggetürmtes
beruehrte	NN	beruehrte
besorgniserregend	ADJD	besorgniserregend
bestaetigte	ADJD	bestaetigte
besteht	VVFIN	bestehen
bestens	ADV	bestens
bezw	VVFIN	bezw
bislang	ADV	bislang
blos	VVFIN	blos
bloss	ADJD	bloß
blosse	ADJA	bloß
blutarm	ADJD	blutarm
blästige	ADJA	blästige
blödsinnigen	ADJA	blödsinnig
bösartiger	ADJA	bösartiger
bürgerl	ADJA	bürgerl
cakes	ADJA	cakes
calceo	NN	calceo
causality	NE	causality
cerebrorum	ADJA	cerebrorum
characterisiert	ADJA	characterisiert
coelis	NE	coelis
coelo	NE	coelo
complizierten	ADJA	complizierten
corrig	NE	corrig
corrigiert	NE	corrigiert
coute	NN	coute
d'essai	NE	d'essai
daheim	ADV	daheim
darauf-hin	ADJA	darauf-hin
darnieder	NN	darnieder
darst	ADJD	darst
debita	ADJA	debita
debitoribus	NN	debitoribus
demnächst	ADV	demnächst
denkfaul	ADJD	denkfaul
dereinst	ADV	dereinst
dermatologische	ADV	dermatologische
dersticken	VVFIN	dersticken
derzeit	ADV	derzeit
diesbezüglich	ADJD	diesbezüglich
diesesmal	ADV	diesesmal
dimitte	NN	dimitte
dimittimus	NN	dimittimus
dixere	ADJA	dixere
dortgelassen	NN	dortgelassen
draussen	ADV	draußen
dreibändige	ADJA	dreibändig
dreibändigen	ADJA	dreibändig
dreiklavierige	ADJA	dreiklavierige
dreiklavierigen	ADJA	dreiklavierigen
dreizehnjährigen	ADJA	dreizehnjährig
droben	ADV	droben
dummerweise	ADV	dummerweise
durch's	VVFIN	durch's
durchgraut	ADJA	durchgraut
dz	NN	dz
ehrenvollen	ADJA	ehrenvoll
ehrenvoller	ADJA	ehrenvoller
eigenthümliche	ADJA	eigenthümliche
ein's	VVFIN	einen
ein-zwei	ADJD	ein-zwei
einberufen	VVINF	einberufen
einbändigen	VVFIN	einbändigen
eingehendst	ADJD	eingehendst
einjähriger	ADJA	einjährig
einpaar	NN	einpaar
einsmals	ADV	einsmals
einverwoben	ADJA	einverwoben
einwandfreie	ADJA	einwandfrei
einwenig	NN	einwenig
elem	ADJA	elem
empfaende	NN	empfaende
empfiel	VVFIN	empfiel
endgültiger	ADJD	endgültig
engelsgut	ADJD	engelsgut
engl	ADJA	engl
englisch-deutschen	ADJA	englisch-deutsch
entblöste	ADJA	entblöste
entgehn	ADJA	entgehn
erfolgreichen	ADJA	erfolgreich
erfreun	ADJA	erfreun
ergebenst	ADJD	ergeben
ergehn	ADJA	ergehn
erhälst	ADJA	erhälst
erkenntnistheoretische	ADJA	erkenntnistheoretisch
erklaeren	ADJA	erklaeren
ernhof-St	ADJA	ernhof-St
erreignisreichen	ADJA	erreignisreichen
erwaehnt	ADJA	erwaehnt
erwiedere	NN	erwiedere
erwiedert	VVFIN	erwiedert
ev	NE	Ev
evt	VVFIN	evt
facias	NE	facias
fecisti	NE	fecisti
feldgrauen	ADJA	feldgrau
feststellbarer	ADJA	feststellbarer
flackerts	NN	flackerts
fragwürdiger	ADJA	fragwürdig
frag	VVIMP	fragen
freun	ADJA	freun
freundl	NN	freundl
freundlichern	VVFIN	freundlichern
freundlichst	ADJD	freundlich
freut's	VVFIN	freuen
frühest	ADJD	früh
fuer	ADJD	fuer
für's	VVFIN	für's
gaenzlich	ADJD	gaenzlich
garnichts	NN	Garnichts
ge	VVFIN	ge
gebrau	ADJD	gebrau
gedankenreicher	ADJD	gedankenreicher
gefühlvoll	ADJD	gefühlvoll
gegenwaertigen	ADJA	gegenwaertigen
gegrüsst	VVPP	grüßen
gegrüß	VVIMP	gegrüß
gehorsamst	ADJD	gehorsam
gehts's	VVFIN	gehts's
geht’s	ADJA	geht’s
geistreichen	ADJA	geistreich
gemüthlichen	ADJA	gemüthlichen
genoßen	ADJA	genoßen
genuch	NN	genuch
genußreich	ADJD	genussreich
genußreicher	ADJD	genußreicher
gequählt	ADJA	gequählt
geringschätze	NN	geringschätze
geringschätzt	VVFIN	geringschätzen
gesammten	ADJA	gesammten
gesch	NE	gesch
gescheidt	NE	gescheidt
gescheidter	ADJA	gescheidter
geschlaften	NN	geschlaften
geschloßen	VVFIN	geschloßen
geschmackvoller	ADJD	geschmackvoll
gewuenscht	ADJD	gewuenscht
geäussert	VVPP	äußern
gieb	ADJA	gieb
giebt	ADJA	giebt
gieng	NE	gieng
gienge	VVFIN	gienge
gleichgiltig	ADJD	gleichgiltig
gleichgueltig	ADJD	gleichgueltig
gleichwinklige	ADJA	gleichwinklige
gleichwinkliges	ADJA	gleichwinkliges
gloriae	NN	gloriae
glückwünschen	ADJA	glückwünschen
gottseidank	NN	gottseidank
groessten	VVFIN	groessten
gross	ADJD	groß
grossen	ADJA	groß
großartiger	ADJA	großartig
großartiges	ADJA	großartig
gruss	NN	Gruß
grössere	ADJA	groß
grösste	ADJA	groß
grössten	ADJA	groß
grüsse	VVFIN	grüßen
grüssen	VVFIN	grüßen
grüssend	ADJD	grüssend
grüsst	VVFIN	grüßen
gutmachen	VVFIN	gutmachen
gutmütigern	ADJD	gutmütigern
gutschreiben	VVINF	gutschreiben
gährt	VVFIN	gährt
gütigst	ADJD	gütig
haelt	ADJA	haelt
haette	NN	haette
handgeschrieben	ADJD	handgeschrieben
handschriftlich	ADJD	handschriftlich
handschriftliche	ADJA	handschriftlich
hast's	VVFIN	hast's
heimgekehrt	VVPP	heimkehren
heimlicherweise	ADJD	heimlicherweise
herausgehängt	VVPP	heraushängen
herausreisse	ADJD	herausreisse
herbeigesehnt	VVPP	herbeisehnen
herrlich	ADJD	herrlich
herumschleppen	VVFIN	herumschleppen
herzl	ADJD	herzl
herzlichst	ADJD	herzlich
herzlychn	ADJA	herzlychn
heuter	NN	heuter
hierst	VVFIN	hierst
hingebracht	VVPP	hinbringen
hingerissen	VVPP	hinreißen
hingewöhnt	ADJD	hingewöhnt
hinkommst	VVFIN	hinkommen
hinnieden	VVFIN	hinnieden
hinsichtlich	APPR	hinsichtlich
hinüberschlüge	NN	hinüberschlüge
histor	ADJD	histor
hochachtungsvoll	ADV	hochachtungsvoll
hochanständiger	ADJD	hochanständiger
hochdeutsch	ADJD	hochdeutsch
hocherfreut	ADJD	hocherfreut
hochgeehrter	ADJD	hochgeehrt
hochgegangen	VVPP	hochgehen
hochherzigen	ADJA	hochherzig
hochverehrter	ADJA	hochverehrt
hodie	NN	hodie
hoffnungsvoller	ADJA	hoffnungsvoll
holländ	NE	holländ
honor	NE	honor
humorvollen	ADJA	humorvoll
hundsgemeineres	ADJA	hundsgemeineres
häftig	ADJD	häftig
häl	VVFIN	häl
immolabant	ADJD	immolabant
in's	VVFIN	in's
incarnatus	NE	incarnatus
indeß	NE	indeß
inducas	NE	inducas
ingenti	ADJA	ingenti
inhibirt	NN	inhibirt
innigst	ADJD	innig
inpavescit	NN	inpavescit
insinnieren	VVFIN	insinnieren
insoferne	NN	insoferne
inständigst	ADJD	inständig
interessiren	ADJA	interessiren
interessirt	NN	interessirt
inzwischn	VVFIN	inzwischn
irgendwoanders	ADV	irgendwoanders
irregefuehrt	ADJA	irregefuehrt
jun	NN	jun
kams	ADJD	kams
katastrofal	ADJD	katastrofal
kathol	ADJA	kathol
katzenjämmerlichen	NN	katzenjämmerlichen
ke	VVFIN	ke
keinesfalls	ADV	keinesfalls
kein’s	ADJD	kein’s
klarlegen	VVINF	klarlegen
knopst	VVFIN	knopst
komando	NN	komando
kommts	NN	kommts
kopfscheu	ADJD	kopfscheu
kundgeben	VVFIN	kundgeben
laborisch	ADJD	laborisch
langweilt	VVFIN	langweilen
lass	ADJD	laß
laudavere	ADJA	laudavere
lautetete	NN	lautetete
lebensmüde	ADJD	lebensmüde
leichenstill	ADJD	leichenstill
lerweile	VVFIN	lerweile
letzeres	ADJA	letzeres
letzthin	ADV	letzthin
letztwilligen	ADJA	letztwilligen
leuteten	ADJA	leuteten
lhnen	NN	lhnen
lhr	NN	lhr
lhre	NN	lhre
lhren	NN	lhren
libera	NE	libera
liebenswürdigen	ADJA	liebenswürdig
liebenswürdiger	ADJA	liebenswürdig
liesest	VVFIN	liesest
lind-geschäftig	ADJD	lind-geschäftig
lnnsbrucker	NN	lnnsbrucker
lnteresse	NN	lnteresse
lobensw	ADJD	lobensw
lobenswert	ADJD	lobenswert
losgerungen	ADJA	losgerungen
lotrecht	NN	lotrecht
loß	VVFIN	loß
luftlos	ADJD	luftlos
längstens	ADV	längstens
magi	NE	Magi
malo	NE	malo
manchesmal	ADV	manchesmal
maschingeschriebenen	ADJA	maschingeschriebenen
maschinschriftlich	ADJD	maschinschriftlich
matematisches	ADJA	matematisches
maximas	NN	maximas
mehrmonatlichem	ADJA	mehrmonatlichem
meinetwillen	ADV	meinetwillen
meißt	VVFIN	meißt
meißten	ADJA	meißten
merito	NE	merito
merk's	VVFIN	merk's
mhd	NE	mhd
mieß	VVFIN	mieß
mihi	NE	mihi
mildtätiger	ADJA	mildtätiger
misbrauchen	NN	misbrauchen
misisti	NE	misisti
mitgedruckt	VVPP	mitdrucken
mittlerweile	ADV	mittlerweile
mittwöchige	ADV	mittwöchige
moeglich	ADJD	moeglich
monatelangem	ADJA	monatelang
mortuus	ADJA	mortuus
muendliche	ADJA	muendliche
munifizente	NN	munifizente
mustergültigen	ADJA	mustergültig
myrrham	NN	myrrham
mü	NE	mü
mühevollem	ADJA	mühevoll
müße	NN	müße
nachhause	VVFIN	nachhausen
nachläßige	ADJA	nachläßige
naechste	NN	naechste
nahegeht	VVFIN	nahegehen
nato	NE	Nato
natus	NE	natus
nebst	APPR	nebst
neuerdings	ADV	neuerdings
neugeschrieben	ADJD	neugeschrieben
nicht-logischen	ADJA	nicht-logischen
niederorganisierte	NN	niederorganisierte
nimmt's	VVFIN	nehmen
nm	NE	nm
nobis	NE	nobis
noster	NN	noster
nostra	NE	nostra
nostris	NE	nostris
nostrum	NN	nostrum
notdürftig	ADJD	notdürftig
notus	NE	notus
novi	NE	novi
nächstens	ADV	nächstens
nächstes	ADJA	nah
obendrein	ADV	obendrein
objectiv	ADJD	objectiv
oesterreichische	ADJA	oesterreichische
offengestanden	VVFIN	offengestehen
officiellen	ADJA	officiellen
ohnedies	ADV	ohnedies
okulte	ADJA	okulte
operirt	NN	operirt //REWRITE
ordinem	ADJA	ordinem
ordnungsmäßig	ADJD	ordnungsmäßig
overleaf	ADJA	overleaf
pastores	NN	pastores
peinlich-ruhiger	ADJD	peinlich-ruhiger
plattdeutsch	ADJD	plattdeutsch
populär-wissenschaftliche	ADJA	populär-wissenschaftliche
portabant	NN	portabant
preiszugeben	VVIZU	preisgeben
preoccupiert	ADJD	preoccupiert //REWRITE
propos	ADJA	propos
psychologisch-sprachlicher	ADJA	psychologisch-sprachlicher
puer	ADJA	puer
quand	NN	quand
qui	NE	qui
quibus	NN	quibus
quotidianum	ADJD	quotidianum
ratenweise	ADV	ratenweise
rechtzeitig	ADJD	rechtzeitig
refüsirte	NN	refüsirte //UNKNOWN
regelmässige	ADJA	regelmässig
regi	NE	Regi
regnum	NN	regnum
reißaus	ADJD	reißaus
religieusen	ADJA	religieusen //ABKÜRZUNG
resonet	ADJA	resonet
respektvollster	ADJA	respektvoll
richtiggehende	ADJA	richtiggehend
riskiren	NN	riskiren //REWRITE
rm	ADJA	rm //ABKÜRZUNG
rue	NN	rue
räsonnieren	VVINF	räsonnieren
sag's	VVFIN	sagen
saudumm	ADJD	saudumm
scharfkantige	ADJA	scharfkantig
<<<<<<< HEAD
sche	ADJA	sche //
scheinheilige	ADJA	scheinheilig
scheints	NN	scheints
schen	VVFIN	schen //UNKNOWN
=======
scheinheilige	ADJA	scheinheilig
scheints	NN	scheints
>>>>>>> 3a29f5937b4947309c6b4b8537d6347daf572ba2
scheusslich	ADJD	scheußlich
scheusslichen	ADJA	scheußlich
schlechtgewählter	NN	schlechtgewählter
schliesse	VVFIN	schließen
schliesslich	ADV	schließlich
schreibfaul	ADJD	schreibfaul
schw	ADJA	schw //ABKÜRZUNG
schwehr	NN	schwehr //REWRITE
schwerbedachten	VVFIN	schwerbedachten
schwerbeladener	ADJD	schwerbeladener
schwummerlich	ADJD	schwummerlich
sehrgut	ADJA	sehrgut
sehrjung	NN	sehrjung
sehrmüde	ADJD	sehrmüde
seither	ADV	seither
sei’s	ADJA	sei’s
sejen	NN	sejen
selbstherrliche	ADJA	selbstherrlich
selbstzufriedenen	ADJA	selbstzufrieden
selbständigeres	ADJA	selbständigeres
setz	VVIMP	setzen
sgesetzt	ADJD	sgesetzt //ABKÜRZUNG
sicherzustellen	VVIZU	sicherstellen
sicut	NE	sicut
so-so	NE	so-so
sororem	NN	sororem
sowas	PIS	sowas
steeren	ADJA	steeren
stehts	NN	stehts
sye	ADJD	sye
sympatisch	ADJD	sympatisch
tance	NN	tance
teilnehmend	ADJD	teilnehmend
telegra	NN	telegra //ABKÜRZUNG
telegraphisch	ADJD	telegraphisch
telephonisch	ADJD	telephonisch
temperamentvoll	ADJD	temperamentvoll
tentationem	ADJA	tentationem
terra	NN	terra
terre	ADJD	terre
teueren	ADJA	teuer
th	ADJA	th
thiefer	ADJA	thiefer
thäten	ADJA	thäten
tibi	NN	tibi
tiefempfundene	ADJA	tiefempfunden
tiefgefühlt	ADJA	tiefgefühlt
tieftraurige	ADJA	tieftraurig
timere	ADJA	timere
totenblaß	ADJD	totenblass
transzendentales	ADJA	transzendental
trau's	VVFIN	trau's
tua	NE	tua
tuen	ADJA	tuen
tus	ADJA	tus
tuum	NN	tuum
tête	ADJA	tête
uebrigen	ADJA	uebrigen
uebrigens	NN	uebrigens //REWRITE
umarmen	VVINF	umarmen
umbrennt	VVFIN	umbrennt
umsonst	ADV	umsonst
umsoweniger	ADJA	umsoweniger
umstaenden	ADJA	umstaenden //REWRITE
umzusetzender	ADJA	umzusetzender
unanständigen	ADJA	unanständig
unanständiger	ADJA	unanständig
unanständigerweise	ADJA	unanständigerweise
unapetitlichen	ADJA	unapetitlichen //REWRITE
unbegründet	ADJD	unbegründet
unbemittelte	ADJA	unbemittelt
unberücksichtigten	ADJA	unberücksichtigt
unbeschädigt	ADJD	unbeschädigt
unbestellbar	ADJD	unbestellbar
unbürgerliche	ADJA	unbürgerliche
unerwünschten	ADJA	unerwünscht
ung	NN	ung //ABKÜRZUNG
ungemeinem	ADJA	ungemeinem
ungemäß	ADJD	ungemäß
ungesehn	ADJD	ungesehn
ungesichtet	ADJD	ungesichtet
ungewiss	ADJD	ungewiss
unglückselige	ADJA	unglückselig
unlebendig	ADJD	unlebendig
unnötigerweise	ADV	unnötigerweise
unterdessen	ADV	unterdessen
unternährt	ADJA	unternährt
unvorsehbares	ADJA	unvorsehbares
unwirdesch	NE	unwirdesch //UNKNOWN
unüberlegt	ADJD	unüberlegt
vadis	NE	vadis
vejtgasze	ADJA	vejtgasze
verantwortungsvollere	ADJA	verantwortungsvoll
vere	ADJA	vere //ABKÜRZUNG
vergang	NN	vergang
vergerben	ADJA	vergerben
verhuellen	NN	verhuellen //REWRITE
verlagstechnisch	ADJD	verlagstechnisch
veroeffentlicht	ADJA	veroeffentlicht //REWRITE
verschweinert	ADJA	verschweinert
verwant	ADJA	verwant
viechischen	ADJA	viechischen
vielmals	ADV	vielmals
vielversprechender	ADJD	vielversprechend 
vierhändig	ADJD	vierhändig
vierhändige	ADJA	vierhändig
villeicht	ADJA	villeicht
vitatam	NE	vitatam
vobis	NE	vobis
voellig	ADJD	voellig //REWRITE
voluntas	ADJA	voluntas
vora	NN	vora //ABKÜRZUNG
vorgeschwätzt	VVPP	vorgeschwätzt
vorneherein	ADV	vorneherein
vorwurfsvollem	ADJA	vorwurfsvoll
vorübergehn	ADJA	vorübergehn
vorüberkommen	ADJA	vorüberkommen
wachthabenden	NN	wachthabenden
waffentauglich	ADJD	waffentauglich
wahrheitsgetreue	ADJA	wahrheitsgetreu
wahrlich	ADV	wahrlich
wards	VVFIN	wards
weidlich	ADV	weidlich
weils	NN	weils
weiss	ADJD	weiß
weiterbefoerdert	VVFIN	weiterbefoerdert
weltgeschichtlichen	ADJA	weltgeschichtlich
weltverbessernden	ADJA	weltverbessernd
wenigst	ADJD	wenigst
wertvoller	ADJA	wertvoll
wettschwimmen	NN	Wettschwimmen
widerholen	ADJA	widerholen
wiedersehn	ADJA	wiedersehn //REWRITE
wiederzusehn	TRUNC	wiederzusehn //REWRITE
wiewohl	KOUS	wiewohl
wirrisch	ADJD	wirrisch
wishe	ADJA	wishe
wishes	ADJA	wishes
wochenlangem	ADJA	wochenlang
wochenlanges	ADJA	wochenlang
wohlauf	ADV	wohlauf
wohlfühle	VVFIN	wohlfühlen
wohlgemeinten	ADJA	wohlgemeint
wohlgetan	VVPP	wohltun
wohltuend	ADJD	wohltuend
wohlwollenden	ADJA	wohlwollend
wol	NN	wol
woltätige	ADJA	woltätige
wortbrüchig	ADJD	wortbrüchig
wuerde	NN	wuerde
wunderschönes	ADJA	wunderschön
wundervoll	ADJD	wundervoll
wär	ADJD	wär
wärend	ADJD	wärend
wärmstens	ADJA	wärmstens
yeux	NN	yeux
zehnfach	ADJD	zehnfach
zeitgemäße	ADJA	zeitgemäß
zuallererst	ADV	zuallererst
zubeordert	ADJD	zubeordert
zugestossen	VVPP	zustoßen
zugewiesen	VVPP	zuweisen
zugut	ADJD	zugut
zumuthen	NN	zumuthen
zurueckschicken	VVINF	zurueckschicken
zurueckzuschicken	VVINF	zurueckzuschicken
zurückbekommen	VVINF	zurückbekommen
zurückerhielt	VVFIN	zurückerhalten
zurückverwiesen	VVPP	zurückverweisen
zusammenzeichnen	ADJA	zusammenzeichnen
zuverläßiger	ADJA	zuverläßiger
zuwideres	ADJA	zuwideres
<<<<<<< HEAD
zw	ADJA	zw //ABKÜRZUNG
zwiscchen	ADJA	zwiscchen //REWRITE
=======
zw	ADJA	zw
zwiscchen	ADJA	zwiscchen
Ö	ADJA	Ö
>>>>>>> 3a29f5937b4947309c6b4b8537d6347daf572ba2
Österr	NN	Österr
Österrike	NE	Österrike
Überflüssigkeit	NN	Überflüssigkeit
ßte	ADJA	ßte //ABKÜRZUNG
äusseren	ADJA	aussen
äusserlich	ADJD	äußerlich
ça	ADJA	ça
österr	NN	österr //ABKÜRZUNG
übele	VVFIN	übele
übelzunehmen	VVIZU	übelnehmen
über's	VVFIN	über's
überflüssigen	ADJA	überflüssig
überg	NN	überg //ABKÜRZUNG
übergenuch	NN	übergenuch
übergrosse	ADJA	übergroß
überlauten	VVINF	überlauten
überwies	VVFIN	überweisen
überübernächste	ADJA	überübernah
überübernächsten	ADJA	überübernächsten
Genoveva	NE	Genoveva
Gyges	ADJA	Gyges //UNKNOWN
Herodes	ADJA	Herodes
Makabäer	NN	Makabäer
Scheißhäusel	NN	Scheißhäusel
