Siglum	NE	Siglum
:	$.	:
b1904_00_00_an_WittgensteinPaulBruder	NN	b1904_00_00_an_WittgensteinPaulBruder
Title	NE	Title
:	$.	:
Von	APPR	von
Ludwig	NE	Ludwig
Wittgenstein	NE	Wittgenstein
an	APPR	an
Paul	NE	Paul
Wittgenstein	NE	Wittgenstein
(	$(	(
Bruder	NN	Bruder
)	$(	)
,	$,	,
[	$(	[
1904	CARD	@card@
?	$.	?
]	$(	]
sourceDesc	NE	sourceDesc
:	$.	:
Abschrift	NN	Abschrift
McGuinness	NE	McGuinness
,	$,	,
Kopie	NN	Kopie
in	APPR	in
BA	NE	BA
.	$.	.
Text	NN	Text
:	$.	:
Lieber	ADJD	lieb
Paul	NE	Paul
!	$.	!
Vielen	PIAT	viele
Dank	NN	Dank
für	APPR	für
Deinen	PPOSAT	dein
lieben	ADJA	lieb
Brief	NN	Brief
.	$.	.
Ich	PPER	ich
bin	VAFIN	sein
jetzt	ADV	jetzt
natürlich	ADV	natürlich
sehr	ADV	sehr
beschäftigt	VVPP	beschäftigen
,	$,	,
und	KON	und
darum	PAV	darum
kommt	VVFIN	kommen
mir	PPER	ich
mein	PPOSAT	mein
Darmzustand	NN	Darmzustand
nicht	PTKNEG	nicht
gerade	ADV	gerade
erwünscht	ADJD	erwünscht
.	$.	.
Es	PPER	es
geht	VVFIN	gehen
mir	PPER	ich
aber	ADV	aber
schon	ADV	schon
bedeutend	ADJD	bedeutend
besser	PTKVZ	besser
und	KON	und
wenn	KOUS	wenn
ich	PPER	ich
mich	PRF	ich
morgen	ADV	morgen
beim	APPRART	bei
Dr.	NN	Dr.
Lindner	NE	Lindner
untersuchen	VVINF	untersuchen
lassen	VVINF	lassen
werde	VAFIN	werden
hoffe	VVFIN	hoffen
ich	PPER	ich
nur	ADV	nur
gutes	ADJA	gut
zu	PTKZU	zu
hören	VVINF	hören
,	$,	,
da	KOUS	da
ich	PPER	ich
seit	APPR	seit
dem	ART	die
letzten	ADJA	letzt
Anfall	NN	Anfall
am	APPRART	an
Sonntag	NN	Sonntag
nichts	PIS	nichts
mehr	ADV	mehr
gespürt	VVPP	spüren
habe	VAFIN	haben
.	$.	.
Auch	ADV	auch
in	APPR	in
der	ART	die
Schule	NN	Schule
geht	VVFIN	gehen
es	PPER	es
mir	PRF	ich
gut	ADJD	gut
und	KON	und
die	ART	die
Striglin	NN	Striglin
ist	VAFIN	sein
weder	KON	weder
dümmer	ADJD	dumm
noch	ADV	noch
gescheiter	ADJD	gescheit
geworden	VAPP	werden
.	$.	.
Jetzt	ADV	jetzt
noch	ADV	noch
wie	KOKOM	wie
geht’s	NN	geht’s
der	ART	die
alten	ADJA	alt
Elis	NE	Elis
’	NN	’
und	KON	und
der	ART	die
Woletz	NN	Woletz
,	$,	,
und	KON	und
hast	VAFIN	haben
Du	PPER	du
schon	ADV	schon
andre	PIAT	andere
Leute	NN	Leute
gefunden	VVPP	finden
,	$,	,
die	PRELS	die
Dich	PPER	du
auch	ADV	auch
an	APPR	an
diese	PDAT	dies
beiden	PIAT	beide
Leporel[l]i	NN	Leporel[l]i
erinnern	VVINF	erinnern
?	$.	?
Die	ART	die
Großmama	NN	Großmama
lasse	VVFIN	lassen
ich	PPER	ich
viel	ADV	viel
,	$,	,
viel	ADV	viel
,	$,	,
viel	ADV	viel
--	$(	--
--	$(	--
--	$(	--
-	$(	-
mals	ADJD	mals
grüßen	VVINF	grüßen
.	$.	.
Es	PPER	es
hofft	VVFIN	hoffen
Dich	PPER	du
und	KON	und
alle	PIAT	alle
andern	PIS	andere
froh	ADJD	froh
wiederzusehen	VVIZU	wiedersehen
Dein	PPOSAT	dein
Dich	PPER	du
liebender	ADJA	liebend
Bruder	NN	Bruder
Luki	NN	Luki
