Siglum	NE	Siglum
:	$.	:
b1897_00_00_an_KrämerJohannVictor	NN	b1897_00_00_an_KrämerJohannVictor
Title	NE	Title
:	$.	:
Von	APPR	von
Ludwig	NE	Ludwig
Wittgenstein	NE	Wittgenstein
an	APPR	an
Johann	NE	Johann
Victor	NE	Victor
Krämer	NE	Krämer
,	$,	,
[	$(	[
1897	CARD	@card@
]	$(	]
sourceDesc	NE	sourceDesc
:	$.	:
Original	ADJD	original
an	APPR	an
der	ART	die
ÖNB	NN	ÖNB
(	$(	(
Autogr	NN	Autogr
.	$.	.
1439/3-1	CARD	@card@
)	$(	)
;	$.	;
Scans	NN	Scans
in	APPR	in
BA	NE	BA
.	$.	.
Text	NN	Text
:	$.	:
Lieber	ADJA	lieb
Herr	NN	Herr
Krämer	NE	Krämer
!	$.	!
Ich	PPER	ich
hoffe	VVFIN	hoffen
dass	KOUS	dass
es	PPER	es
Ihnen	PPER	Sie
gut	ADJD	gut
geht	VVFIN	gehen
und	KON	und
danke	VVFIN	danken
Ihnen	PPER	Sie
vielmals	ADV	vielmals
für	APPR	für
Ihren	PPOSAT	ihr
Gruß	NN	Gruß
.	$.	.
Wenn	KOUS	wenn
Sie	PPER	Sie
wieder	ADV	wieder
nach	APPR	nach
Neuwaldegg	NE	Neuwaldegg
kommen	VVINF	kommen
werde	VAFIN	werden
ich	PPER	ich
Ihnen	PPER	Sie
viel	ADV	viel
erzählen	VVINF	erzählen
.	$.	.
Ich	PPER	ich
unterhalte	VVFIN	unterhalten
mich	PRF	ich
hier	ADV	hier
ausgezeichnet	VVPP	auszeichnen
.	$.	.
Leider	ADV	leider
fahren	VVFIN	fahren
wir	PPER	wir
schon	ADV	schon
Mittwoch	NN	Mittwoch
nach	APPR	nach
Neuwaldegg	NE	Neuwaldegg
.	$.	.
Mit	APPR	mit
vielen	PIAT	viele
Grußen	NN	Grußen
Ihr	PPOSAT	ihr
Luki	NN	Luki
Besten	ADJA	gut
Gruß	NN	Gruß
von	APPR	von
Kurt	NE	Kurt
